Amaia screeches into the parking lot, and expertly zips into an open spot.  She closes her eyes briefly, checking, then opens them again, only fractionally less concerned.  "OK," she says, breathlessly, "whatever it is that's going to happen hasn't happened yet.  Zora," she turns to you apologetically over her shoulder, "you won't have a lot of time, but the future's still branching, so it should be enough.  Lestar, you're up." 

From the passenger seat, Lestar grins at both of you, his white eyebrows quirking soothingly, and he reaches behind his seat to pat you reassuringly on the arm.  "You got this, kid," he says "You've been doing great; this'll be just like the other times."  From Amaia's panicked expression, you can tell she disagrees, but she says nothing.  You take a deep breath and grab Lestar's hand, dry and warm, and it grounds you.

Amaia takes Lestar's other hand, then grabs yours, the contact sleek with sweat from both of you.  Lestar nods at you both, and closes his eyes.

Everything freezes.

You have all the time in the world.

Fate's Gallery
An Interactive Story by Lucian Smith
Release 1 / Serial number 230808 / Inform 7 v10.1.2 / D

Quinlan Park Parking Lot (in the Hyundai)
Scattered cars fill the parking lot, including the Hyundai. The parking lot is just off of 48th street to the west.   To the north is the entrance to the park.

Looming over the parking lot to the east is a huge sculpture {whose details have yet to be decided.  But it definitely looms. LS DEBUG.}

Amaia is turned sideways in the driver's seat, grasping your hand and Lestar's.  Even frozen, she radiates intensity and movement.

Lestar's eyes are shut in calm concentration.  His relaxed hands hold yours and Amaia's, completing the triangle.

In the area, you can sense the collective presence of dozens of spiders.

>actions
Actions listing on.

>rules
Rules tracing now switched on. Type "rules off" to switch it off again, or "rules all" to include even rules which do not apply.

[Rule "parse command rule" applies.]

* * *

>undo
Parking Lot
[Previous turn undone.]

* * *

>rules off
[Rule "declare everything initially unmentioned rule" applies.]
Rules tracing now switched off. Type "rules" to switch it on again.

>s
[going south]

Parking Lot
The parking lot is just off of 48th street to the west.   To the north is the entrance to the park.

In the area, you can sense the collective presence of dozens of spiders.

You can also see a Hyundai (in which are Zora, Amaia and Lestar) here.

[going south - succeeded]

A cloud passes over the sun.

>enter spiders
[entering the spiders]
You get into the spiders.

[entering the spiders - succeeded]

>n
[going north]

Entrance
Two booths flank the entrance to the park, where you can buy tickets and get information.  The parking lot to the south is mostly empty, but you can see some people walking through the park to the north.

[going north - succeeded]

* * *

>enter amaia
You can't imagine actually entering Amaia's consciousness and giving her full access to your mind.  You'd never be able to look her in the eye again, and you have to work with her.

>x lester
(It's "Lestar", not "Lester".)

>lester, hi
(It's "Lestar", not "Lester".)

>enter spiders
With practiced ease, you move your consciousness out of your own head, and into the surrounding spiders.  Your perception shifts, and you see the parking lot as if you were standing in it, though patched together from dozens of small views.

Quinlan Park Parking Lot (in the spiders)
Scattered cars fill the parking lot, including the Hyundai The parking lot is just off of 48th street to the west.   To the north is the entrance to the park.

Looming over the parking lot to the east is a huge sculpture whose details have yet to be decided.  But it definitely looms.

>enter amaia
You can't imagine actually entering Amaia's consciousness and giving her full access to your mind.  You'd never be able to look her in the eye again, and you have to work with her.

>s
That direction seems to be outside Lestar's area of influence.  Hopefully that means you won't need to go that way.

>n
You transfer your consiousness to a new group of spiders...

Quinlan Park Entrance (in the spiders)
Two booths flank the entrance to the park, where you can buy tickets and get information.  The parking lot to the south is mostly empty, but you can see some people walking through the park to the north.

>n
You transfer your consiousness to a new group of spiders...

Plaza (in the spiders)
Paths run through this plaza from the south entrance, then splitting northwest around the hill, north up the hill, and east along it. 

Prominently displayed just inside the entrance is some sort of sculpture.

>n
You transfer your consiousness to a new group of spiders...

Playground (in the spiders)
Slides, swings, and a wide variety of brightly-colored climbing equipment.  The path curves from the south to the east here, along the ridge of the hill.

>n
You transfer your consiousness to a new group of spiders...

Beach Sculpture (in the spiders)
An east-west path runs along the Brushstroke Reservoir beach. A large complicated structure sits here, fodder for some sort of puzzle.  To your south, you can see the playground on top of the hill.

>n
The open water doesn't have any spiders for you to transfer to.

>w
You transfer your consiousness to a new group of spiders...

Under Bridge (in the spiders)
A simple and delicate sculpture entitled "Fire and Forge" sits here, nestled under the 48th Street Bridge on the banks of Brushstroke Reservoir to the north.  The path leads back southeast.

>w
That direction seems to be outside Lestar's area of influence.  Hopefully that means you won't need to go that way.

>nw
The open water doesn't have any spiders for you to transfer to.

>sw
That direction seems to be outside Lestar's area of influence.  Hopefully that means you won't need to go that way.

>s
That direction seems to be outside Lestar's area of influence.  Hopefully that means you won't need to go that way.

>se
You transfer your consiousness to a new group of spiders...

Path By Hill (in the spiders)
The path runs southwest to northeast here, and splits off to the northeast as well, all skirting the hill above you to the east.  A fence mostly hidden by shrubbery to your west hides 48th street, and blocks most of the sound from the passing cards

>n
You transfer your consiousness to a new group of spiders...

Under Bridge (in the spiders)
A simple and delicate sculpture entitled "Fire and Forge" sits here, nestled under the 48th Street Bridge on the banks of Brushstroke Reservoir to the north.  The path leads back southeast.

* * *

>enter lestar
Lestar's been nothing but kind to you, but you're sure if he saw your whole mind, he'd be disappointed.  You've touched his mind before and that's gone OK.  You guess.  You hope.

>enter amaia
You can't imagine actually entering Amaia's consciousness and giving her full access to your mind.  You'd never be able to look her in the eye again, and you have to work with her.

>touch lestar
Reaching out with your mind, you brush Lestar's surface thoughts with your own.  Instantly, you feel the thought, "Hi, Zora!  Just figure out what's going on, then get people to safety.  You can do this."  It must have been waiting for you, which in retrospect you feel you should have anticipated.  He's an old Vested, after all, and has been doing this for years.

>touch amaia
Amaia still intimidates you, and you're pretty sure her surface thoughts would just be "Zora!  Do your job already!"

>enter zora
You're already in yourself, for what that's worth.

* * *

>enter spiders
With practiced ease, you move your consciousness out of your own head, and into the surrounding spiders.  Your perception shifts, and you see the parking lot as if you were standing in it, though patched together from dozens of small views.

Quinlan Park Parking Lot (in the spiders)
Scattered cars fill the parking lot, including the Hyundai. The parking lot is just off of 48th street to the west.   To the north is the entrance to the park.

Looming over the parking lot to the east is a huge sculpture {whose details have yet to be decided.  But it definitely looms. LS DEBUG.}

>e
You spot a spider on the east wall, and through it, move your consciousness to the spiders on the other side.

Sculpture By Lot (in the spiders)
The path curves from the west to the southeast here, winding through a giant sculpture that looms over the fence by the parking lot.  The main hill of the park is to the north.

Up the hill to the north is the red metal tubes and bars of Coyote's Call.

>e
You transfer your consiousness to a new group of spiders...

Bewildering Bridges (in the spiders)
Three paths from the west, northwest, and north converge here at a bewildering complex of bridges, walkways, and staircases, some fixed, and some turning gently in the wind.

A ways northwest up the hill you can see the iconic red metal structure of Coyote's Call.

Whatever Amaia is worried about is apparently happening in this park.  You'll need to wait to advance the loop to see what's going on.

* * *

>e
You spot a spider on the east wall, and through it, move your consciousness to the spiders on the other side.

Sculpture By Lot (in the spiders)
The path curves from the west to the southeast here, winding through a giant sculpture that looms over the fence by the parking lot.  The main hill of the park is to the north.

Up the hill to the north is the red metal tubes and bars of Coyote's Call.

>n
You transfer your consiousness to a new group of spiders...

Top of Hill (in the spiders)
From the top of the hill, you can see the entire park below you: the reservoir to the north, the playground to the west, and all eight of the permanent sculptures in the park.  The sculpture here dominates the hill, and looks like a great place for puzzles LS DEBUG.

>undo
Sculpture By Lot
You step backwards on the strands.

>x coyote
Coyote's Call is the iconic sculpture of Quinlan Park.  Made of large red metal tubes and beams, it dominates the landscape from atop the central hill to the east.

>se
You transfer your consiousness to a new group of spiders...

Bewildering Bridges (in the spiders)
Three paths from the west, northwest, and north converge here at a bewildering complex of bridges, walkways, and staircases, some fixed, and some turning gently in the wind.

A ways northwest up the hill you can see the iconic red metal structure of Coyote's Call.

>nw
You transfer your consiousness to a new group of spiders...

Top of Hill (in the spiders)
From the top of the hill, you can see the entire park below you: the reservoir to the north, the playground to the west, and all eight of the permanent sculptures in the park.  The sculpture here dominates the hill, and looks like a great place for puzzles LS DEBUG.

>se
You transfer your consiousness to a new group of spiders...

Bewildering Bridges (in the spiders)
Three paths from the west, northwest, and north converge here at a bewildering complex of bridges, walkways, and staircases, some fixed, and some turning gently in the wind.

A ways northwest up the hill you can see the iconic red metal structure of Coyote's Call.

>n
You transfer your consiousness to a new group of spiders...

East Hill (in the spiders)
A north-south path rises here on the lower east end of the hill.  A sculpture labeled "Bird and Cage" is displayed here; a mass of metal bits on poles.

Up the hill to the west is the iconic red metal structure of Coyote's Call.

>x coyote
Coyote's Call is the iconic sculpture of Quinlan Park.  Made of large red metal tubes and beams, it dominates the landscape from atop the central hill to the northeast.

>w
You transfer your consiousness to a new group of spiders...

Top of Hill (in the spiders)
From the top of the hill, you can see the entire park below you: the reservoir to the north, the playground to the west, and all eight of the permanent sculptures in the park.  The sculpture here dominates the hill, and looks like a great place for puzzles LS DEBUG.

>e
You transfer your consiousness to a new group of spiders...

East Hill (in the spiders)
A north-south path rises here on the lower east end of the hill.  A sculpture labeled "Bird and Cage" is displayed here; a mass of metal bits on poles.

Up the hill to the west is the iconic red metal structure of Coyote's Call.

>n
You transfer your consiousness to a new group of spiders...

Water Sculpture (in the spiders)
Here at the northeast section of the park is a fountain-sculpture-thing in the shallow water of the reservoir.  Paths run from here south along the edge of the hill, southwest up the hill, and west along the beach.

To the southwest atop the hill is the iconic red metal structure of Coyote's Call.

>sw
You transfer your consiousness to a new group of spiders...

Top of Hill (in the spiders)
From the top of the hill, you can see the entire park below you: the reservoir to the north, the playground to the west, and all eight of the permanent sculptures in the park.  The sculpture here dominates the hill, and looks like a great place for puzzles LS DEBUG.

>ne
You transfer your consiousness to a new group of spiders...

Water Sculpture (in the spiders)
Here at the northeast section of the park is a fountain-sculpture-thing in the shallow water of the reservoir.  Paths run from here south along the edge of the hill, southwest up the hill, and west along the beach.

To the southwest atop the hill is the iconic red metal structure of Coyote's Call.

>w
You transfer your consiousness to a new group of spiders...

Beach Sculpture (in the spiders)
An east-west path runs along the Brushstroke Reservoir beach. A large complicated structure sits here, fodder for some sort of puzzle.  To your south, you can see the playground on top of the hill.

To the southeast atop the hill is the iconic red metal structure of Coyote's Call.

>se
You transfer your consiousness to a new group of spiders...

Top of Hill (in the spiders)
From the top of the hill, you can see the entire park below you: the reservoir to the north, the playground to the west, and all eight of the permanent sculptures in the park.  The sculpture here dominates the hill, and looks like a great place for puzzles LS DEBUG.

>nw
You transfer your consiousness to a new group of spiders...

Beach Sculpture (in the spiders)
An east-west path runs along the Brushstroke Reservoir beach. A large complicated structure sits here, fodder for some sort of puzzle.  To your south, you can see the playground on top of the hill.

To the southeast atop the hill is the iconic red metal structure of Coyote's Call.

>w
You transfer your consiousness to a new group of spiders...

Under Bridge (in the spiders)
A simple and delicate sculpture entitled "Fire and Forge" sits here, nestled under the 48th Street Bridge on the banks of Brushstroke Reservoir to the north.  The path leads back southeast to the main park area.

>se
You transfer your consiousness to a new group of spiders...

Path By Hill (in the spiders)
The path runs southwest to northeast here along the edge of the park, and splits off to the northeast as well, heading up the hill above you to the east.  A fence mostly hidden by shrubbery to your west hides 48th street, and blocks most of the sound from the passing cards

To the east you can still see the tops of the red metal structure of Coyote's Call.

>e
You transfer your consiousness to a new group of spiders...

Playground (in the spiders)
You're at the top of the hill in the park.  This side has slides, swings, and a wide variety of brightly-colored climbing Climbing equipment.  The path curves from the south to the east side of the hill, along the ridge.

Kids are playing, shrieking, and chasing each other up and around the platforms.

Dominating the sky to the east is the red metal tubes and bars of Coyote's Call.

* * *

>e
You spot a spider on the east wall, and through it, move your consciousness to the spiders on the other side.

Sculpture By Lot (in the spiders)
The path curves from the west to the southeast here, winding through a giant sculpture that looms over the fence by the parking lot.  The main hill of the park is to the north.

Up the hill to the north is the red metal tubes and bars of Coyote's Call.

>w
You spot a spider on the west wall, and through it, move your consciousness to the spiders on the other side.

Quinlan Park Parking Lot (in the spiders)
Scattered cars fill the parking lot, including the Hyundai. The parking lot is just off of 48th street to the west.   To the north is the entrance to the park.

Looming over the parking lot to the east is a huge sculpture {whose details have yet to be decided.  But it definitely looms. LS DEBUG.}

>n
You transfer your consiousness to a new group of spiders...

Quinlan Park Entrance (in the spiders)
Two booths flank the entrance to the park, where you can buy tickets and get information.

>n
You transfer your consiousness to a new group of spiders...

Plaza (in the spiders)
Paths run through this plaza from the south entrance, then splitting northwest around the hill, north up the hill, and east along it. 

Prominently displayed just inside the entrance is some sort of sculpture.

>x people
You can't use multiple objects with that verb.

>x park goest
You can't see any such thing.

>x park goers
The park is well-attended today, with a variety of park-goers enjoying the day and the scenery.

>x park-goers
The park is well-attended today, with a variety of park-goers enjoying the day and the scenery.

>actions
Actions listing on.

>x people
You can't use multiple objects with that verb.

* * *

>enter spiders
With practiced ease, you move your consciousness out of your own head, and into the surrounding spiders.  Your perception shifts, and you see the parking lot as if you were standing in it, though patched together from dozens of small views.

Quinlan Park Parking Lot (in the spiders)
Scattered cars fill the parking lot, including the Hyundai. The parking lot is just off of 48th street to the west.   To the north is the entrance to the park.

Looming over the parking lot to the east is a huge sculpture {whose details have yet to be decided.  But it definitely looms. LS DEBUG.}

>enter hyundai
You transfer your consciousness into the spiders inside the car.

Quinlan Park Parking Lot (in the spiders) (in the Hyundai)
Scattered cars fill the parking lot, including the Hyundai The parking lot is just off of 48th street to the west.   To the north is the entrance to the park.

Looming over the parking lot to the east is a huge sculpture whose details have yet to be decided.  But it definitely looms.

Amaia is turned sideways in the driver's seat, grasping your hand and Lestar's.  Even frozen, she radiates intensity and movement.

Lestar's eyes are shut in calm concentration.  His relaxed hands hold yours and Amaia's, completing the triangle.

Your own face relaxes as you look at yourself from the outside.  Somehow, it's easier to see yourself this way than in the mirror.

>actions
Actions listing on.

>go out
[going outside]
[(1) exiting]
You transfer your consciousness into the spiders outside the car.

[(2) looking]
Quinlan Park Parking Lot (in the spiders)
Scattered cars fill the parking lot, including the Hyundai The parking lot is just off of 48th street to the west.   To the north is the entrance to the park.

Looming over the parking lot to the east is a huge sculpture whose details have yet to be decided.  But it definitely looms.

[(2) looking - succeeded]

[(1) exiting - succeeded]

[going outside - succeeded]

>exit
[exiting]
You can't exit one consciousness without going into another one.
[exiting - ended without result]

>in
[going inside]
That direction seems to be outside Lestar's area of influence.  Hopefully that means you won't need to go that way.
[going inside - failed]

>enter
[entering the spiders]
Your conciousness is already inhabiting the spiders.
[entering the spiders - failed]

I beg your pardon?

>up
[going up]
That direction seems to be outside Lestar's area of influence.  Hopefully that means you won't need to go that way.
[going up - failed]

* * *

>enter spiders
With practiced ease, you move your consciousness out of your own head, and into the surrounding spiders.  Your perception shifts, and you see the parking lot as if you were standing in it, though patched together from dozens of small views.

Quinlan Park Parking Lot (in the spiders)
Scattered cars fill the parking lot, including the Hyundai. The parking lot is just off of 48th street to the west.   To the north is the entrance to the park.

Looming over the parking lot to the east is a huge sculpture {whose details have yet to be decided.  But it definitely looms. LS DEBUG.}

>n
You transfer your consiousness to a new group of spiders...

Quinlan Park Entrance (on the spiders)
Two booths flank the entrance to the park, where you can buy tickets and get information.

>n
You transfer your consiousness to a new group of spiders...

Plaza (on the spiders)
Paths run through this plaza from the south entrance, then splitting northwest around the hill, north up the hill, and east along it. 

Prominently displayed just inside the entrance is some sort of sculpture.

>n
You transfer your consiousness to a new group of spiders...

Playground (in the spiders)
Slides, swings, and a wide variety of brightly-colored climbing equipment.  The path curves from the south to the east here, along the ridge of the hill.

>e
You transfer your consiousness to a new group of spiders...

Top of Hill (in the spiders)
From the top of the hill, you can see the entire park below you: the reservoir to the north, the playground to the west, and all eight of the permanent sculptures in the park.  The sculpture here dominates the hill, and looks like a great place for puzzles LS DEBUG.

>z
Gently, you release your hold on time, letting it briefly move forward.

Time passes.

>l
Top of Hill (in the spiders)
From the top of the hill, you can see the entire park below you: the reservoir to the north, the playground to the west, and all eight of the permanent sculptures in the park.  The sculpture here dominates the hill, and looks like a great place for puzzles LS DEBUG.

>l
Top of Hill (in the spiders)
From the top of the hill, you can see the entire park below you: the reservoir to the north, the playground to the west, and all eight of the permanent sculptures in the park.  The sculpture here dominates the hill, and looks like a great place for puzzles LS DEBUG.

>z
Gently, you release your hold on time, letting it briefly move forward.

Time passes.

A cloud passes over the sun.

>z
Gently, you release your hold on time, letting it briefly move forward.

Time passes.

You feel an ominous rumbling from deep under the earth.

>z
Gently, you release your hold on time, letting it briefly move forward.

Time passes.

With a roar, the entire top of the hill collapses in on itself, and your perception shatters as spiders are shaken off webs and perches, spinning out emergency strands to catch the wind and slow their falls.  Straining, you manage to reassert your hold on time, freezing everything in place again.  Gradually, you stitch together a new coherent view of your surroundings.

Giant Pit (in the spiders)
The entire hill has collapsed in on itself, revealing a giant pit underneath. Bushes and trees are frozen mid-fall, as they pitch forward into the yawning chasm.
(LS DEBUG describe the changed sculpture.)

>z
Gently, you release your hold on time, letting it briefly move forward.

Time passes.

>z
Gently, you release your hold on time, letting it briefly move forward.

Time passes.

The sun emerges again from behind the cloud.

>l
Giant Pit (in the spiders)
The entire hill has collapsed in on itself, revealing a giant pit underneath. Bushes and trees are frozen mid-fall, as they pitch forward into the yawning chasm.
(LS DEBUG describe the changed sculpture.)

>undo
Giant Pit
You step backwards on the strands.

>undo
Top of Hill
You step backwards on the strands.

>undo
Top of Hill
You step backwards on the strands.

>undo
You've gone as far backwards on this strand as you can manage.

>undo
You've gone as far backwards on this strand as you can manage.

* * *

>n
You transfer your consiousness to a new group of spiders...

Plaza (on the spiders)
Paths run through this plaza from the south entrance, then splitting northwest around the hill, north up the hill, and east along it. 

Prominently displayed just inside the entrance is some sort of sculpture.

>x people
The park is well-attended today, with a variety of park-goers enjoying the day and the scenery.

>enter people
Entering someone's mind is traumatic enough that you're not going to do it without some particular reason.

>n
You transfer your consiousness to a new group of spiders...

Playground (on the spiders)
You're at the top of the hill in the park.  This side has slides, swings, and a wide variety of brightly-colored climbing Climbing equipment.  The path curves from the south to the east side of the hill, along the ridge.

Kids are playing, shrieking, and chasing each other up and around the platforms.

>enter kids
Hoo boy, as traumatic as it is for you to enter people's minds, you'd rather not inflict full access to an adult mind on a pre-teen, even if they're supposed to forget afterwards.

>undo
Playground
You step backwards on the strands.

>actions
Actions listing on.

>enter kids
[entering Kids]
Hoo boy, as traumatic as it is for you to enter people's minds, you'd rather not inflict full access to an adult mind on a pre-teen, even if they're supposed to forget afterwards.
[entering Kids - failed]

* * *

>n
You transfer your consiousness to a new group of spiders...

Quinlan Park Entrance (on the spiders)
Two booths flank the entrance to the park, where you can buy tickets and get information.

>s
Parking Lot (in the spiders)
The parking lot is just off of 48th street to the west.   To the north is the entrance to the park.

You can see a Hyundai (in which are Amaia, Lestar and Zora) here.

A cloud passes over the sun.

>enter spiders
Your conciousness is already inhabiting the spiders.

>l
Parking Lot (in the spiders)
The parking lot is just off of 48th street to the west.   To the north is the entrance to the park.

You can see a Hyundai (in which are Amaia, Lestar and Zora) here.

>actions
Actions listing on.

>exit spiders
I only understood you as far as wanting to exit.

>exit
[exiting]
You can't exit one consciousness without going into another one.
[exiting - ended without result]

>enter spiders
[entering the spiders]
Your conciousness is already inhabiting the spiders.
[entering the spiders - failed]

>enter hyundai
[entering the Hyundai]
You transfer your consciousness into the spiders inside the car.

[(1) looking]
Parking Lot (in the spiders) (in the Hyundai)
The parking lot is just off of 48th street to the west.   To the north is the entrance to the park.

Amaia is turned sideways in the driver's seat, grasping your hand and Lestar's.  Even frozen, she radiates intensity and movement.

Lestar's eyes are shut in calm concentration.  His relaxed hands hold yours and Amaia's, completing the triangle.

Your own face relaxes as you look at yourself from the outside.  Somehow, it's easier to see yourself this way than in the mirror.

[(1) looking - succeeded]

[entering the Hyundai - succeeded]

>enter lester
You can't see any such thing.

>enter lestar
[entering Lestar]
Lestar's been nothing but kind to you, but you're sure if he saw your whole mind, he'd be disappointed.  You've touched his mind before and that's gone OK.  You guess.
[entering Lestar - failed]

>enter amaia
[entering Amaia]
You can't imagine actually entering Amaia's consciousness and giving her full access to your mind.  You'd never be able to look her in the eye again, and you have to work with her.
[entering Amaia - failed]

>enter spiders
[entering the spiders]
Your conciousness is already inhabiting the spiders.
[entering the spiders - failed]

>exit
[exiting]
You transfer your consciousness into the spiders outside the car.

[(1) looking]
Parking Lot (in the spiders)
The parking lot is just off of 48th street to the west.   To the north is the entrance to the park.

You can see a Hyundai (in which are Amaia, Lestar and Zora) here.

[(1) looking - succeeded]

[exiting - succeeded]

>touch lestar
[touching Lestar]
Reaching out with your mind, you brush Lestar's surface thoughts with your own.  Instantly, you feel the thought, "Hi, Zora!  Just figure out what's going on, then get people to safety.  You can do this."  It must have been waiting for you, which in retrospect you feel you should have anticipated.  He's an old Vested, after all, and has been doing this for years.
[touching Lestar - succeeded]

* * *

>enter spiders
With practiced ease, you move your consciousness out of your own head, and into the surrounding spiders.  Your perception shifts, and you see the parking lot as if you were standing in it, though patched together from dozens of small views.

Quinlan Park Parking Lot (in the spiders)
Scattered cars fill the parking lot, including the Hyundai. The parking lot is just off of 48th street to the west.   To the north is the entrance to the park.

Looming over the parking lot to the east is a huge sculpture {whose details have yet to be decided.  But it definitely looms. LS DEBUG.}

>undo
Parking Lot
[Previous turn undone.]

>actions
Actions listing on.

>enter spiders
[entering the spiders]
With practiced ease, you move your consciousness out of your own head, and into the surrounding spiders.  In no time at all, your perception shifts, and you're perceiving the parking lot as if you were standing in it, though patched together from a thousand small views.

Probably due to your nervousness, a memory surfaces of the first time you managed this.

[(1) looking]
Parking Lot (in the spiders)
The parking lot is just off of 48th street to the west.   To the north is the entrance to the park.

You can see a Hyundai (in which are Amaia, Lestar and Zora) here.

[(1) looking - succeeded]

[Zora entering the spiders - succeeded]

>l
[looking]
Parking Lot (in the spiders)
The parking lot is just off of 48th street to the west.   To the north is the entrance to the park.

You can see a Hyundai (in which are Amaia, Lestar and Zora) here.

[looking - succeeded]

>rules
Rules tracing now switched on. Type "rules off" to switch it off again, or "rules all" to include even rules which do not apply.

[Rule "parse command rule" applies.]

* * *

>enter lestar
[Rule "declare everything initially unmentioned rule" applies.]
[Rule "generate action rule" applies.]
[entering Lestar]
[Rule "announce items from multiple object lists rule" applies.]
[Rule "set pronouns from items from multiple object lists rule" applies.]
[Rule "before stage rule" applies.]
[Rule "basic visibility rule" applies.]
[Rule "basic accessibility rule" applies.]
[Rule "access through barriers rule" applies.]
[Rule "can't reach outside closed containers rule" applies.]
[Rule "can't reach inside rooms rule" applies.]
[Rule "can't reach inside closed containers rule" applies.]
[Rule "carrying requirements rule" applies.]
[Rule "instead stage rule" applies.]
[Rule "Instead of entering Lestar when the player is enclosed by a person ( called host )" applies.]
Lestar's been nothing but kind to you, but you're sure if he saw your whole mind, he'd be disappointed.  You've touched his mind before and that's gone OK.  You guess.
[entering Lestar - failed]

[Rule "A first turn sequence rule" applies.]
[Rule "scene change machinery rule" applies.]
[Rule "take quick actions out of world rule" applies.]
[Rule "parse command rule" applies.]

>touch lestar
[Rule "declare everything initially unmentioned rule" applies.]
[Rule "generate action rule" applies.]
[touching Lestar]
[Rule "announce items from multiple object lists rule" applies.]
[Rule "set pronouns from items from multiple object lists rule" applies.]
[Rule "before stage rule" applies.]
[Rule "basic visibility rule" applies.]
[Rule "basic accessibility rule" applies.]
[Rule "access through barriers rule" applies.]
[Rule "can't reach outside closed containers rule" applies.]
[Rule "can't reach inside rooms rule" applies.]
[Rule "can't reach inside closed containers rule" applies.]
[Rule "carrying requirements rule" applies.]
[Rule "instead stage rule" applies.]
[Rule "Instead of touching Lestar" applies.]
Reaching out with your mind, you brush Lestar's surface thoughts with your own.  Instantly, you feel the thought, "Hi, Zora!  Just figure out what's going on, then get people to safety.  You can do this."  It must have been waiting for you, which in retrospect you feel you should have anticipated.  He's an old Vested, after all, and has been doing this for years.
[touching Lestar - succeeded]

[Rule "A first turn sequence rule" applies.]
[Rule "scene change machinery rule" applies.]
[Rule "take quick actions out of world rule" applies.]
[Rule "parse command rule" applies.]

>rules off
[Rule "declare everything initially unmentioned rule" applies.]
[Rule "generate action rule" applies.]
Rules tracing now switched off. Type "rules" to switch it on again.

>touch amaia
[touching Amaia]
Amaia still intimidates you, and you're pretty sure her surface thoughts would be "Zora!  Do your job already!"
[touching Amaia - succeeded]

>exit from spiders
I only understood you as far as wanting to exit.

>fprward
That's not a verb I recognise.

>go forward
You can't see any such thing.

* * *

>enter spiders
With practiced ease, you move your consciousness out of your own head, and into the surrounding spiders.  Your perception shifts, and you see the parking lot as if you were standing in it, though patched together from dozens of small views.

Quinlan Park Parking Lot (in the spiders)
Scattered cars fill the parking lot, including the Hyundai. The parking lot is just off of 48th street to the west.   To the north is the entrance to the park.

Looming over the parking lot to the east is a huge sculpture {whose details have yet to be decided.  But it definitely looms. LS DEBUG.}

>x looming
It's a sculpture looming over the east fence.

>x fence
A fence walls off the park to the east.

>restart
Are you sure you want to restart?

>y
Amaia screeches into the parking lot, and expertly zips into an open spot.  She closes her eyes briefly, checking, then opens them again, only fractionally less concerned.  "OK," she says, breathlessly, "whatever it is that's going to happen hasn't happened yet.  Zora," she turns to you apologetically over her shoulder, "you won't have a lot of time, but the future's still branching, so it should be enough.  Lestar, you're up." 

From the passenger seat, Lestar grins at both of you, his white eyebrows quirking soothingly, and he reaches behind his seat to pat you reassuringly on the arm.  "You got this, kid," he says "You've been doing great; this'll be just like the other times."  From Amaia's panicked expression, you can tell she disagrees, but she says nothing.  You take a deep breath and grab Lestar's hand, dry and warm, and it grounds you.

Amaia takes Lestar's other hand, then grabs yours, the contact sleek with sweat from both of you.  Lestar nods at you both, and closes his eyes.

Everything freezes.

You have all the time in the world.

Fate's Gallery
An Interactive Story by Lucian Smith
Release 1 / Serial number 230730 / Inform 7 v10.1.2 / D

Quinlan Park Parking Lot (in the Hyundai)
The parking lot is just off of 48th street to the west.   To the north is the entrance to the park.

Looming over the parking lot to the east is a huge sculpture whose details have yet to be decided.  But it definitely looms.

Amaia is turned sideways in the driver's seat, grasping your hand and Lestar's.  Even frozen, she radiates intensity and movement.

Lestar's eyes are shut in calm concentration.  His relaxed hands hold yours and Amaia's, completing the triangle.

In the area, you can sense the collective presence of dozens of spiders.

>enter spiders
With practiced ease, you move your consciousness out of your own head, and into the surrounding spiders.  Your perception shifts, and you see the parking lot as if you were standing in it, though patched together from dozens of small views.

Probably due to your nervousness, a memory surfaces of the first time you managed this.

Quinlan Park Parking Lot (in the spiders)
The parking lot is just off of 48th street to the west.   To the north is the entrance to the park.

Looming over the parking lot to the east is a huge sculpture whose details have yet to be decided.  But it definitely looms.

The Hyundai is parked with almost mathematical precision between two other cars.  You'd never guess that this was accomplished in 1.5 seconds.  Unless you knew Amaia.  Which you do.  But still.

* * *

>enter spiders
With practiced ease, you move your consciousness out of your own head, and into the surrounding spiders.  Your perception shifts, and you see the parking lot as if you were standing in it, though patched together from dozens of small views.

Quinlan Park Parking Lot (in the spiders)
Scattered cars fill the parking lot, including the Hyundai. The parking lot is just off of 48th street to the west.   To the north is the entrance to the park.

Looming over the parking lot to the east is a huge sculpture {whose details have yet to be decided.  But it definitely looms. LS DEBUG.}

>x me
Your consciousness has no literal form, but when you move across minds, you imagine your core self as a tight ball of sparks containing your memories.

* * *

>enter spiders
With practiced ease, you move your consciousness out of your own head, and into the surrounding spiders.  Your perception shifts, and you see the parking lot as if you were standing in it, though patched together from dozens of small views.

Quinlan Park Parking Lot (in the spiders)
Scattered cars fill the parking lot, including the Hyundai. The parking lot is just off of 48th street to the west.   To the north is the entrance to the park.

Looming over the parking lot to the east is a huge sculpture {whose details have yet to be decided.  But it definitely looms. LS DEBUG.}

>z
Time passes.

>l
Quinlan Park Parking Lot (in the spiders)
Scattered cars fill the The parking lot is just off of 48th street to the west.   To the north is the entrance to the park.

Looming over the parking lot to the east is a huge sculpture whose details have yet to be decided.  But it definitely looms.

The Hyundai is parked with almost mathematical precision between two other cars.  You'd never guess that this was accomplished in 1.5 seconds.  Unless you knew Amaia.  Which you do.  But still.

>l
Quinlan Park Parking Lot (in the spiders)
Scattered cars fill the The parking lot is just off of 48th street to the west.   To the north is the entrance to the park.

Looming over the parking lot to the east is a huge sculpture whose details have yet to be decided.  But it definitely looms.

The Hyundai is parked with almost mathematical precision between two other cars.  You'd never guess that this was accomplished in 1.5 seconds.  Unless you knew Amaia.  Which you do.  But still.

>z
Time passes.

* * *

>l
Quinlan Park Parking Lot (in the spiders)
Scattered cars fill the The parking lot is just off of 48th street to the west.   To the north is the entrance to the park.

Looming over the parking lot to the east is a huge sculpture whose details have yet to be decided.  But it definitely looms.

The Hyundai is parked with almost mathematical precision between two other cars.  You'd never guess that this was accomplished in 1.5 seconds.  Unless you knew Amaia.  Which you do.  But still.

>z
Time passes.

A cloud passes over the sun.

>x me
Your consciousness has no literal form, but when you move across minds, you imagine your core self as a tight ball of sparks containing your memories.

>x ball of sparks
Your consciousness has no literal form, but when you move across minds, you imagine your core self as a tight ball of sparks containing your memories.

>x spiders
The minds of the spiders are refreshingly simple, unlike most people's minds.  You can enter them to explore an area.

* * *

>in
You'll have to be more specific about what you want to enter.

>out
While frozen, you can enter the minds around you, and you're aware of your surroundings, but can't do anything physical.

>enter spiders
With practiced ease, you move your consciousness out of your own head, and into the surrounding spiders.  Your perception shifts, and you see the parking lot as if you were standing in it, though patched together from dozens of small views.

Quinlan Park Parking Lot (in the spiders)
Scattered cars fill the parking lot, including the Hyundai The parking lot is just off of 48th street to the west.   To the north is the entrance to the park.

Looming over the parking lot to the east is a huge sculpture whose details have yet to be decided.  But it definitely looms.

>in
You'll have to be more specific about what you want to enter.

>out
You can't exit one consciousness without going into another one.

>actions
Actions listing on.

>up
[going up]
Unfortunately, you're not one of the Vested that can fly.
[going up - failed]

>get out
[exiting]
You can't exit one consciousness without going into another one.
[exiting - ended without result]

>get out of hyundai
I only understood you as far as wanting to get outside.

>enter hyundai
[entering the Hyundai]
You transfer your consciousness into the spiders inside the car.

[(1) looking]
Quinlan Park Parking Lot (in the spiders) (in the Hyundai)
Scattered cars fill the parking lot, including the Hyundai The parking lot is just off of 48th street to the west.   To the north is the entrance to the park.

Looming over the parking lot to the east is a huge sculpture whose details have yet to be decided.  But it definitely looms.

Amaia is turned sideways in the driver's seat, grasping your hand and Lestar's.  Even frozen, she radiates intensity and movement.

Lestar's eyes are shut in calm concentration.  His relaxed hands hold yours and Amaia's, completing the triangle.

Your own face relaxes as you look at yourself from the outside.  Somehow, it's easier to see yourself this way than in the mirror.

[(1) looking - succeeded]

[entering the Hyundai - succeeded]

>exit hyundai
I only understood you as far as wanting to exit.

>out
[exiting]
You transfer your consciousness into the spiders outside the car.

[(1) looking]
Quinlan Park Parking Lot (in the spiders)
Scattered cars fill the parking lot, including the Hyundai The parking lot is just off of 48th street to the west.   To the north is the entrance to the park.

Looming over the parking lot to the east is a huge sculpture whose details have yet to be decided.  But it definitely looms.

[(1) looking - succeeded]

[exiting - succeeded]

>undo
Quinlan Park Parking Lot
[Previous turn undone.]

* * *

>kiss hyundai
You can only do that to something animate.

>hyundai, hi
You can't talk to the Hyundai.

>lestar, hi
From here, you can enter the minds around you, but not much else.  It should be enough to figure out what's going on.

>actions
Actions listing on.

>lestar, hi
[answering Lestar that "hi"]
From here, you can enter the minds around you, but not much else.  It should be enough to figure out what's going on.
[answering Lestar that "hi" - failed]

>tell lestar about me
[telling Lestar about "me"]
From here, you can enter the minds around you, but not much else.  It should be enough to figure out what's going on.
[telling Lestar about "me" - failed]

>kiss lestar
[kissing Lestar]
From here, you can enter the minds around you, but not much else.  It should be enough to figure out what's going on.
[kissing Lestar - failed]

>out
[exiting]
From here, you can enter the minds around you, but not much else.  It should be enough to figure out what's going on.
[exiting - failed]

>amaia, hi
[answering Amaia that "hi"]
With Lestar anchoring everything in the present, you can't interact with Amaia physically.  You could in theory enter her mind, but she is entirely too intimidating for that.  Even touching her mind to connect your surface thoughts is kind of beyond the pale.
[answering Amaia that "hi" - failed]

>enter spiders
[entering the spiders]
With practiced ease, you move your consciousness out of your own head, and into the surrounding spiders.  Your perception shifts, and you see the parking lot as if you were standing in it, though patched together from dozens of small views.

Probably due to your nervousness, a memory surfaces of the first time you managed this.

[(1) looking]
Parking Lot (in the spiders)
The parking lot is just off of 48th street to the west.   To the north is the entrance to the park.

The Hyundai is parked with almost mathematical precision between two other cars.  You'd never guess that this was accomplished in 1.5 seconds.  Unless you knew Amaia.  Which you do.  But still.

[(1) looking - succeeded]

[Zora entering the spiders - succeeded]

>amaia, hi
[answering Amaia that "hi"]
With Lestar anchoring everything in the present, you can't interact with Amaia physically.  You could in theory enter her mind, but she is entirely too intimidating for that.  Even touching her mind to connect your surface thoughts is kind of beyond the pale.
[answering Amaia that "hi" - failed]

>enter amaia
[entering Amaia]
You can't imagine actually entering Amaia's consciousness and giving her full access to your mind.  You'd never be able to look her in the eye again, and you have to work with her.
[entering Amaia - failed]

>touch amaia
[touching Amaia]
Amaia still intimidates you, and you're pretty sure her surface thoughts would just be "Zora!  Do your job already!"
[touching Amaia - succeeded]

>tree
(Compass object) (567784) 
  the north
  the northeast
  the northwest
  the south
  the southeast
  the southwest
  the east
  the west
  the up
  the down
  the inside
  the outside
(thedark object) (567816) 
(VPH_25) (567848) 
(VPH_2) (567880) 
your former self (568296) 
Parking Lot (568328) 
  some spiders
    yourself
  a Hyundai
    Amaia
    Lestar
    Zora
Entrance (568520) 
Plaza (568552) 
  Sculpture Number One
Path By Hill (568616) 
Playground (568648) 
Sculpture By Lot (568680) 
Under Bridge (568712) 
  Fire and Forge
plaque (568776) 
fire_forged (568808) 
twisted metal (568840) 
Beach Sculpture (568872) 
Top Of Hill (568904) 
Bewildering Bridges (568936) 
East Hill (568968) 
  Bird_Cage
Water Sculpture (569032) 
Void (569064) 
giant bushy white eyebrows (569128)

>x me
[examining yourself]
Your consciousness has no literal form, but when you move across minds, you imagine your core self as a tight ball of sparks containing your memories.

[examining yourself - succeeded]

>x zora
[examining Zora]
You're pragmatically dressed in jeans, a "Hu" T-shirt, and sneakers.  Your curls are somehow behaving today, probably because you didn't try to do anything with them this morning.

[examining Zora - succeeded]

>restart
[restarting the game]
Are you sure you want to restart?

>y
Amaia screeches into the parking lot, and expertly zips into an open spot.  She closes her eyes briefly, checking, then opens them again, only fractionally less concerned.  "OK," she says, breathlessly, "whatever it is that's going to happen hasn't happened yet.  Zora," she turns to you apologetically over her shoulder, "you won't have a lot of time, but the future's still branching, so it should be enough.  Lestar, you're up." 

From the passenger seat, Lestar grins at both of you, his white eyebrows quirking soothingly, and he reaches behind his seat to pat you reassuringly on the arm.  "You got this, kid," he says "You've been doing great; this'll be just like the other times."  From Amaia's panicked expression, you can tell she disagrees, but she says nothing.  You take a deep breath and grab Lestar's hand, dry and warm, and it grounds you.

Amaia takes Lestar's other hand, then grabs yours, the contact sleek with sweat from both of you.  Lestar nods at you both, and closes his eyes.

Everything freezes.

You have all the time in the world.

Momentum Moirai
An Interactive Fiction by Lucian Smith
Release 1 / Serial number 230728 / Inform 7 v10.1.2 / D

Parking Lot (in the Hyundai)
The parking lot is just off of 48th street to the west.   To the north is the entrance to the park.

Amaia is turned sideways in the driver's seat, grasping your hand and Lestar's.  Even frozen, she radiates intensity and movement.

Lestar's eyes are shut in calm concentration.  His relaxed hands hold yours and Amaia's, completing the triangle.

In the area, you can sense the collective presence of dozens of spiders.

>l
Parking Lot (in the Hyundai)
The parking lot is just off of 48th street to the west.   To the north is the entrance to the park.

Amaia is turned sideways in the driver's seat, grasping your hand and Lestar's.  Even frozen, she radiates intensity and movement.

Lestar's eyes are shut in calm concentration.  His relaxed hands hold yours and Amaia's, completing the triangle.

In the area, you can sense the collective presence of dozens of spiders.

>x hyundai
Practical, blue, and nondescript.  Not your typical Vested vehicle, but Amaia is more about function than form.

In the Hyundai are Amaia, Lestar and some spiders.

>#I like this bit.
That's not a verb I recognise.

># hello
Noted.

>/hello
That's not a verb I recognise.

>/ hello
Noted.

>'hello
That's not a verb I recognise.

>' hello
Noted.

>" hello
That's not a verb I recognise.

>"hello
That's not a verb I recognise.

* * *

>hyundai, hi
You can't talk to the Hyundai.

>spiders, hi
From here, you can enter the minds around you, but not much else.  It should be enough to figure out what's going on.

>kiss spiders
From here, you can enter the minds around you, but not much else.  It should be enough to figure out what's going on.

>enter spiders
With practiced ease, you move your consciousness out of your own head, and into the surrounding spiders.  Your perception shifts, and you see the parking lot as if you were standing in it, though patched together from dozens of small views.

Probably due to your nervousness, a memory surfaces of the first time you managed this.

Parking Lot (in the spiders)
The parking lot is just off of 48th street to the west.   To the north is the entrance to the park.

You can see a Hyundai (in which are Amaia, Lestar and Zora) here.

>undo
Parking Lot
[Previous turn undone.]

* * *

>l
Parking Lot (in the Hyundai)
The parking lot is just off of 48th street to the west.   To the north is the entrance to the park.

Amaia is turned sideways in the driver's seat, grasping your hand and Lestar's.  Even frozen, she radiates intensity and movement.

Lestar's eyes are shut in calm concentration.  His relaxed hands hold yours and Amaia's, completing the triangle.

In the area, you can sense the collective presence of dozens of spiders.

>out
From here, you can enter the minds around you, but not much else.  It should be enough to figure out what's going on.

>touch me
You achieve nothing by this.

>enter spider
With practiced ease, you move your consciousness out of your own head, and into the surrounding spiders.  Your perception shifts, and you see the parking lot as if you were standing in it, though patched together from dozens of small views.

Probably due to your nervousness, a memory surfaces of the first time you managed this.

Parking Lot (in the spiders)
The parking lot is just off of 48th street to the west.   To the north is the entrance to the park.

You can see a Hyundai (in which are Amaia, Lestar and Zora) here.

>z
Time passes.

>z
Time passes.

A cloud passes over the sun.

>actions
Actions listing on.

>z
[waiting]
Time passes.
[waiting - succeeded]

>z
[waiting]
Time passes.
[waiting - succeeded]

The sun emerges again from behind the cloud.

>z
[waiting]
Time passes.
[waiting - succeeded]

>z
[waiting]
Time passes.
[waiting - succeeded]

* * *

>n
While frozen, you can enter the minds around you, and you're aware of your surroundings, but can't do anything physical.

>n
While frozen, you can enter the minds around you, and you're aware of your surroundings, but can't do anything physical.

>enter spiders
With practiced ease, you move your consciousness out of your own head, and into the surrounding spiders.  Your perception shifts, and you see the parking lot as if you were standing in it, though patched together from dozens of small views.

Quinlan Park Parking Lot (in the spiders)
Scattered cars fill the parking lot, including the Hyundai. The parking lot is just off of 48th street to the west.   To the north is the entrance to the park.

Looming over the parking lot to the east is a huge sculpture {whose details have yet to be decided.  But it definitely looms. LS DEBUG.}

>n
You transfer your consiousness to a new group of spiders...

Quinlan Park Entrance (in the spiders)
Two booths flank the entrance to the park, where you can buy tickets and get information.

You can see an information booth (empty) here.

>n
You transfer your consiousness to a new group of spiders...

Plaza (in the spiders)
Paths run through this plaza from the south entrance, then splitting northwest around the hill, north up the hill, and east along it. 

To the northeast atop the hill is the iconic red metal structure of Coyote's Call.

Prominently displayed just inside the entrance is some sort of sculpture (LS DEBUG).

>x coyote
Coyote's Call is the iconic sculpture of Quinlan Park.  Made of large red metal tubes and beams, it dominates the landscape from atop the central hill to the northeast.

>z
Gently, you release your hold on time, letting it scroll forward.

Time passes.

>z
Gently, you release your hold on time, letting it scroll forward.

Time passes.

A cloud passes over the sun.

>z
Gently, you release your hold on time, letting it scroll forward.

Time passes.

>z
Gently, you release your hold on time, letting it scroll forward.

Time passes.

You feel a slight tremor in the earth from somewhere nearby.

>l
Plaza (in the spiders)
Paths run through this plaza from the south entrance, then splitting northwest around the hill, north up the hill, and east along it. 

To the northeast atop the hill is the iconic red metal structure of Coyote's Call.

Prominently displayed just inside the entrance is some sort of sculpture (LS DEBUG).

>x coyote
Coyote's Call is the iconic sculpture of Quinlan Park.  Made of large red metal tubes and beams, it dominates the landscape from atop the central hill to the northeast.

>smell  coyote
Coyote's Call is too far away.

>get coyote
Coyote's Call is too far away.

>ne
You transfer your consiousness to a new group of spiders...

Top of Hill (in the spiders)
From the top of the hill, you can see the entire park below you: the reservoir to the north, the playground to the west, and all eight of the permanent sculptures in the park.  The sculpture here dominates the hill, and looks like a great place for puzzles LS DEBUG.

>sw
You transfer your consiousness to a new group of spiders...

Plaza (in the spiders)
Paths run through this plaza from the south entrance, then splitting northwest around the hill, north up the hill, and east along it. 

To the northeast atop the hill is the iconic red metal structure of Coyote's Call.

Prominently displayed just inside the entrance is some sort of sculpture (LS DEBUG).

I beg your pardon?

I beg your pardon?

>z
Gently, you release your hold on time, letting it scroll forward.

Time passes.

Whoops, a sinkhole.

>l
Plaza (in the spiders)
Paths run through this plaza from the south entrance, then splitting northwest around the hill, north up the hill, and east along it. 

To the northeast, the iconic red metal of Coyote's Call is no longer visible.

Prominently displayed just inside the entrance is some sort of sculpture (LS DEBUG).

>x coyote
Coyote's Call is the iconic sculpture of Quinlan Park.  Made of large red metal tubes and beams, it dominates the landscape from atop the central hill. Normally, you'd be able to see it to the northeast.

>n
You transfer your consiousness to a new group of spiders...

Playground (in the spiders)
You're at the top of the hill in the park.  This side has slides, swings, and a wide variety of brightly-colored climbing Climbing equipment.  The path curves from the south to the east side of the hill, along the ridge.

Coyote's Call has fallen into the gaping and still-expanding sinkhole.

You can also see Kids here.

>n
You transfer your consiousness to a new group of spiders...

Beach Sculpture (in the spiders)
An east-west path runs along the Brushstroke Reservoir beach. A large complicated structure sits here, fodder for some sort of puzzle.  To your south, you can see the playground on top of the hill.

You can no longer see Coyote's Call to the southeast.

>s
You transfer your consiousness to a new group of spiders...

Playground (in the spiders)
You're at the top of the hill in the park.  This side has slides, swings, and a wide variety of brightly-colored climbing Climbing equipment.  The path curves from the south to the east side of the hill, along the ridge.

Coyote's Call has fallen into the gaping and still-expanding sinkhole.

You can also see Kids here.

>n
You transfer your consiousness to a new group of spiders...

Beach Sculpture (in the spiders)
An east-west path runs along the Brushstroke Reservoir beach. A large complicated structure sits here, fodder for some sort of puzzle.  To your south, you can see the playground on top of the hill.

You can no longer see Coyote's Call to the southeast.

>se
You transfer your consiousness to a new group of spiders...

Giant Pit (in the spiders)
The entire hill has collapsed in on itself, revealing a giant pit underneath. Bushes and trees are frozen mid-fall, as they pitch forward into the yawning chasm.
(LS DEBUG describe the collapsed sculpture.)

* * *

>x amaia
Amaia is a tall dark-haired woman with piercing but tired brown eyes.

* * *

>x lestar
Lestar is an old man with giant bushy white eyebrows that make it impossible for him to hide his emotions.

>x spiders
The minds of the spiders are refreshingly simple, unlike most people's minds.  You can enter them to explore an area.

>enter spiders
With practiced ease, you move your consciousness out of your own head, and into the surrounding spiders.  Your perception shifts, and you see the parking lot as if you were standing in it, though patched together from dozens of small views.

Probably due to your nervousness, a memory surfaces of the first time you managed this.

Quinlan Park Parking Lot (in the spiders)
Scattered cars fill the The parking lot is just off of 48th street to the west.   To the north is the entrance to the park.

Looming over the parking lot to the east is a huge sculpture whose details have yet to be decided.  But it definitely looms.

The Hyundai is parked with almost mathematical precision between two other cars.  You'd never guess that this was accomplished in 1.5 seconds.  Unless you knew Amaia.  Which you do.  But still.

* * *

>x spiders
The minds of the spiders are refreshingly simple, unlike most people's minds.  You can enter them to explore an area.

>x hyundai
Practical, blue, and nondescript.  Not your typical Vested vehicle, but Amaia is more about function than form.

In the Hyundai are Amaia, Lestar and some spiders.

>w
While frozen, you can enter the minds around you, and you're aware of your surroundings, but can't do anything physical.

>x lestar
Lestar is an old man with giant bushy white eyebrows that make it impossible for him to hide his emotions.

>x eyebrows
Yeah, they're kind of hard to not just stare at.

>out
While frozen, you can enter the minds around you, and you're aware of your surroundings, but can't do anything physical.

>enter spiders
With practiced ease, you move your consciousness out of your own head, and into the surrounding spiders.  Your perception shifts, and you see the parking lot as if you were standing in it, though patched together from dozens of small views.

Probably due to your nervousness, a memory surfaces of the first time you managed this.

Parking Lot (in the spiders)
The parking lot is just off of 48th street to the west.   To the north is the entrance to the park.

A fence walls off the park to the east.

The Hyundai is parked with almost mathematical precision between two other cars.  You'd never guess that this was accomplished in 1.5 seconds.  Unless you knew Amaia.  Which you do.  But still.

>w
You can't go that way.

>n
You transfer your consiousness to a new group of spiders...

Entrance (in the spiders)
Two booths flank the entrance to the park, where you can buy tickets and get information.  The parking lot to the south is mostly empty, but you can see some people walking through the park to the north.

>e
You can't go that way.

>s
You transfer your consiousness to a new group of spiders...

Parking Lot (in the spiders)
The parking lot is just off of 48th street to the west.   To the north is the entrance to the park.

A fence walls off the park to the east.

The Hyundai is parked with almost mathematical precision between two other cars.  You'd never guess that this was accomplished in 1.5 seconds.  Unless you knew Amaia.  Which you do.  But still.

>e
You spot a spider on the east wall, and through it, move your consciousness to the spiders on the other side.

Sculpture By Lot (in the spiders)
The path curves from the west to the southeast here, winding through a giant sculpture that looms over the fence by the parking lot.  The main hill of the park is to the north.

>n
You transfer your consiousness to a new group of spiders...

Top Of Hill (in the spiders)
From the top of the hill, you can see the entire park below you: the reservoir to the north, the playground to the west, and all eight of the permanent sculptures in the park.  The sculpture here dominates the hill, and looks like a great place for puzzles.

>w
You transfer your consiousness to a new group of spiders...

Playground (in the spiders)
Slides, swings, and a wide variety of brightly-colored climbing equipment.  The path curves from the south to the east here, along the ridge of the hill.

>w
You transfer your consiousness to a new group of spiders...

Path By Hill (in the spiders)
The path runs southwest to northeast here, and splits off to the northeast as well, all skirting the hill above you to the east.  A fence mostly hidden by shrubbery to your west hides 48th street, and blocks most of the sound from the passing cards

>n
You can't go that way.

>nw
You transfer your consiousness to a new group of spiders...

Under Bridge (in the spiders)
A simple and delicate sculpture entitled "Fire and Forge" sits here, nestled under the 48th Street Bridge on the banks of Brushstroke Reservoir to the north.  The path leads back southeast.

>x fire
A plaque in the ground identifies this sculpture as "Fire and Forge".  Long spines of twisting reddish metal emerges from the ground, reminiscent of flames.

>x forge
A plaque in the ground identifies this sculpture as "Fire and Forge".  Long spines of twisting reddish metal emerges from the ground, reminiscent of flames.

>x fire and forge
A plaque in the ground identifies this sculpture as "Fire and Forge".  Long spines of twisting reddish metal emerges from the ground, reminiscent of flames.

>x fire and me
You can't use multiple objects with that verb.

>x sculpture
A plaque in the ground identifies this sculpture as "Fire and Forge".  Long spines of twisting reddish metal emerges from the ground, reminiscent of flames.

>x spines
As you examine the twisted metal from different angles, you can almost imagine you see both swords and erotic imagery.  This would be consistent with the church of Aphrodite's reclamation of her dominion over both sex and war in its series of reforms in the 70"s and 80"s.  A small stamped icon of a cluster of dates would seem to indicate that the sculptor was part of the Inannan denomination.

I beg your pardon?

>x plaque
Fire and Forge.  Metal and stain, 2007, Amelia Thomas.

The red metal spires most obviously evokes flames, but also passion, leading the majority of scholars to believe this to be representative of the relationship of Aphrodite and Hephaestus.

>x flames
As you examine the twisted metal from different angles, you can almost imagine you see both swords and erotic imagery.  This would be consistent with the church of Aphrodite's reclamation of her dominion over both sex and war in its series of reforms in the 70"s and 80"s.  A small stamped icon of a cluster of dates would seem to indicate that the sculptor was part of the Inannan denomination.

>x dates
As you examine the twisted metal from different angles, you can almost imagine you see both swords and erotic imagery.  This would be consistent with the church of Aphrodite's reclamation of her dominion over both sex and war in its series of reforms in the 70"s and 80"s.  A small stamped icon of a cluster of dates would seem to indicate that the sculptor was part of the Inannan denomination.

* * *

>z
Gently, you release your hold on time, letting it scroll forward.

Time passes.

>l
Quinlan Park Parking Lot (in the Hyundai)
Scattered cars fill the The parking lot is just off of 48th street to the west.   To the north is the entrance to the park.

Looming over the parking lot to the east is a huge sculpture whose details have yet to be decided.  But it definitely looms.

Amaia is turned sideways in the driver's seat, grasping your hand and Lestar's.  Even frozen, she radiates intensity and movement.

Lestar's eyes are shut in calm concentration.  His relaxed hands hold yours and Amaia's, completing the triangle.

In the area, you can sense the collective presence of dozens of spiders.

>l
Quinlan Park Parking Lot (in the Hyundai)
Scattered cars fill the The parking lot is just off of 48th street to the west.   To the north is the entrance to the park.

Looming over the parking lot to the east is a huge sculpture whose details have yet to be decided.  But it definitely looms.

Amaia is turned sideways in the driver's seat, grasping your hand and Lestar's.  Even frozen, she radiates intensity and movement.

Lestar's eyes are shut in calm concentration.  His relaxed hands hold yours and Amaia's, completing the triangle.

In the area, you can sense the collective presence of dozens of spiders.

>z
Time passes.

>l
Quinlan Park Parking Lot (in the Hyundai)
Scattered cars fill the The parking lot is just off of 48th street to the west.   To the north is the entrance to the park.

Looming over the parking lot to the east is a huge sculpture whose details have yet to be decided.  But it definitely looms.

Amaia is turned sideways in the driver's seat, grasping your hand and Lestar's.  Even frozen, she radiates intensity and movement.

Lestar's eyes are shut in calm concentration.  His relaxed hands hold yours and Amaia's, completing the triangle.

In the area, you can sense the collective presence of dozens of spiders.

>z
Time passes.

A cloud passes over the sun.

>l
Quinlan Park Parking Lot (in the Hyundai)
Scattered cars fill the The parking lot is just off of 48th street to the west.   To the north is the entrance to the park.

Looming over the parking lot to the east is a huge sculpture whose details have yet to be decided.  But it definitely looms.

Amaia is turned sideways in the driver's seat, grasping your hand and Lestar's.  Even frozen, she radiates intensity and movement.

Lestar's eyes are shut in calm concentration.  His relaxed hands hold yours and Amaia's, completing the triangle.

In the area, you can sense the collective presence of dozens of spiders.

* * *

>z
Gently, you release your hold on time, letting it scroll forward.

Time passes.

A cloud passes over the sun.

>e
The park continues on the other side of the tall fence to the east, but your host can't scale it.

>enter spiders
With practiced ease, you move your consciousness out of your own head, and into the surrounding spiders.  Your perception shifts, and you see the parking lot as if you were standing in it, though patched together from dozens of small views.

Quinlan Park Parking Lot (in the spiders)
Scattered cars fill the parking lot, including the Hyundai. The parking lot is just off of 48th street to the west.   To the north is the entrance to the park.

Looming over the parking lot to the east is a huge sculpture {whose details have yet to be decided.  But it definitely looms. LS DEBUG.}

* * *

>z
Gently, you release your hold on time, letting it scroll forward.

Time passes.

A cloud passes over the sun.

>x lestar
Lestar is an old man with giant bushy white eyebrows that make it impossible for him to hide his emotions.

>x amaia
Amaia is a tall dark-haired woman with piercing but tired brown eyes.

>enter spiders
With practiced ease, you move your consciousness out of your own head, and into the surrounding spiders.  Your perception shifts, and you see the parking lot as if you were standing in it, though patched together from dozens of small views.

Quinlan Park Parking Lot (in the spiders)
Scattered cars fill the The parking lot is just off of 48th street to the west.   To the north is the entrance to the park.

Looming over the parking lot to the east is a huge sculpture whose details have yet to be decided.  But it definitely looms.

The Hyundai is parked with almost mathematical precision between two other cars.  You'd never guess that this was accomplished in 1.5 seconds.  Unless you knew Amaia.  Which you do.  But still.

>z
Time passes.

* * *

>z
Gently, you release your hold on time, letting it scroll forward.

Time passes.

A cloud passes over the sun.

>z
Time passes.

A cloud passes over the sun.

>z
Time passes.

Whoops, a sinkhole.

>z
Time passes.

The sun emerges again from behind the cloud.