Amaia screeches into the parking lot, and expertly zips into an open spot.  She closes her eyes briefly, checking, then opens them again, only fractionally less concerned.  "OK," she says, breathlessly, "whatever it is that's going to happen hasn't happened yet.  Zora," she turns to you apologetically over her shoulder, "you won't have a lot of time, but the future's still branching, so it should be enough.  Lestar, you're up." 

From the passenger seat, Lestar grins at both of you, his white eyebrows quirking soothingly, and he reaches behind his seat to pat you reassuringly on the arm.  "You got this, kid," he says "You've been doing great; this'll be just like the other times."  From Amaia's panicked expression, you can tell she disagrees, but she says nothing.  You take a deep breath and grab Lestar's hand, dry and warm, and it grounds you.

Amaia takes Lestar's other hand, then grabs yours, the contact sleek with sweat from both of you.  Lestar nods at you both, and closes his eyes.

Everything freezes.

You have all the time in the world.

Fate's Gallery
An Interactive Story by Lucian Smith
Release 0 / Serial number 230820 / Inform 7 v10.1.2 / D

Quinlan Park Parking Lot (in the Hyundai)
Scattered cars fill the parking lot, including the Hyundai you came here in. The parking lot is just off of 48th street to the west.   To the north is the entrance to the park.

Looming over the parking lot to the east is a huge sculpture  whos details have yet to be decided LS TBD.}

Amaia is turned sideways in the driver's seat, grasping your hand and Lestar's.  Even frozen, she radiates intensity and movement.

Lestar's eyes are shut in calm concentration.  His relaxed hands hold yours and Amaia's, completing the triangle.

In the area, you can sense the collective presence of dozens of spiders.

>x amaia
Amaia is a tall dark-haired woman with piercing but tired brown eyes.

* * *

>out
While frozen, you can enter the minds around you, and you're aware of your surroundings, but can't do anything physical.

>enter lestar
Lestar's been nothing but kind to you, but you're sure if he saw your whole mind, he'd be disappointed.  You've touched his mind before and that's gone OK.  You guess.  You hope.

>touch lestar
Reaching out with your mind, you brush Lestar's surface thoughts with your own.  Instantly, you feel the thought, "Hi, Zora!  Just figure out what's going on, then get people to safety.  You can do this."  It must have been waiting for you, which in retrospect you feel you should have anticipated.  He's an old Vested, after all, and has been doing this for years.

* * *

>touch spiders
The surface thoughts of the spiders are entirely instinctual, and refreshing in their simplicity.  You feel your own emotions being acknowledged in return, without them affecting the spiders in the slightest.

>enter spiders
With practiced ease, you move your consciousness out of your own head, and into the surrounding spiders.  Your perception shifts, and you see the parking lot as if you were standing in it, though patched together from dozens of small views.

Quinlan Park Parking Lot (in the spiders)
Scattered cars fill the parking lot, including the Hyundai you came here in. The parking lot is just off of 48th street to the west.   To the north is the entrance to the park.

Looming over the parking lot to the east is a huge sculpture  whos details have yet to be decided LS TBD.}

>x sculpture
It's a sculpture looming over the east fence LS TBD.

>n
You transfer your consiousness to a new group of spiders...

Quinlan Park Entrance (in the spiders)
Two booths flank the entrance to the park to the north, where you can buy tickets and get information.  To the south is the parking lot.

You can see young man manning the ticket booth, but the information booth is empty.

>x booths
Which do you mean, the information booth or the ticket booth?

>information
The information booth is unmanned, but there's a stack of flyers resting on the sill.

>x flyers
The flyer reads:

"Welcome to Quinlan Park!"

"Established in 1974, Dr. Robert Quinlan set aside this portion of his estate as a public park, commisioned the central "Coyote's Call" sculpture from Wynona Locklear, and set up a trust to commission and rotate other art pieces at other sites throughout the park.  Enjoy your stay, and find out more below about our amazing artists!"

Below this is a cartoon map of the park, with small text blocks describing each of the sculptures currently on display:  the central Coyote's Call, then (clockwise from the southwest entrance): <something>, Fire and Forge, <something>, <water sculpture>, Bird and Cage, <bridges>, and <looming> (LS TBD: list the rest, and write the block text for each.  You should eventually be able to "x bird and cage" and get this description if not next to the real thing, and probably "look up bird and cage on map" to be more specific (not implemetned yet)).

>x young man
A young man with a friendly but bored expression, a Quinlan Park employee vest, and a name tag reading "Jace".

* * *

>x jace
A young man with a friendly but bored expression, a Quinlan Park employee vest, and a name tag reading "Jace".

>enter jace
He does seem to have some sort of authority here, but without knowing what the problem is, you'd feel entirely too awkward connecting with him, even just to exchange surface thoughts.

>touch jace
He does seem to have some sort of authority here, but without knowing what the problem is, you'd feel entirely too awkward connecting with him, even just to exchange surface thoughts.

>enter ticket
That's not something you can enter.

* * *

>out
You can't exit one consciousness without going into another one.

>n
You transfer your consiousness to a new group of spiders...

Plaza (in the spiders)
Paths run through this plaza from the south entrance, then splitting northwest around the hill, north up the hill, and east along it. 

To the northeast atop the hill is the iconic red metal structure of Coyote's Call.

Prominently displayed just inside the entrance is some sort of sculpture (LS TBD).

>nw
You transfer your consiousness to a new group of spiders...

Path By Hill (in the spiders)
The path runs southeast to northwest here along the edge of the park, and splits off to the east as well, heading up the hill above you.  A fence mostly hidden by shrubbery to your west hides 48th street, and blocks most of the sound from the passing cars.

Though the hill is in the way, you can still see the tops of the red metal structure of Coyote's Call past the rise to the east.

Whatever Amaia is worried about is apparently happening in this park.  You'll need to wait to advance the loop and see what's going on.

>x call
Coyote's Call is the iconic sculpture of Quinlan Park.  Made of large red metal tubes and beams, it dominates the landscape from atop the central hill to the east.

>e
You transfer your consiousness to a new group of spiders...

>l
Playground (in the spiders)
You're at the top of the hill in the park.  This side has slides, swings, and a wide variety of brightly-colored climbing Climbing equipment.  The path curves from the south to the east side of the hill, along the ridge.

Dominating the sky to the east is the red metal tubes and bars of Coyote's Call.

Kids are playing, shrieking, and chasing each other up and around the platforms.

* * *

>x call
Coyote's Call is the iconic sculpture of Quinlan Park.  Made of large red metal tubes and beams, it dominates the landscape from atop the central hill to the east.

>rules
Rules tracing now switched on. Type "rules off" to switch it off again, or "rules all" to include even rules which do not apply.

[Rule "parse command rule" applies.]

* * *

>z
Gently, you release your hold on time, letting it scroll forward.

>nw
You transfer your consiousness to a new group of spiders...

Under Bridge (in the spiders)
A simple and delicate sculpture entitled "Fire and Forge" sits here, nestled under the 48th Street Bridge on the banks of Brushstroke Reservoir to the north.  The path leads back southeast to the main park area.

>x fire
A plaque in the ground identifies this sculpture as "Fire and Forge".  Long spines of twisting reddish metal emerges from the ground, reminiscent of flames.

>x plaque
Fire and Forge.  Metal and stain, 2007, Amelia Thomas.

The red metal spires most obviously evokes flames, but also passion, leading the majority of scholars to believe this to be representative of the relationship of Aphrodite and Hephaestus.

* * *

>x innanan
As you examine the twisted metal from different angles, you can almost imagine you see both swords and erotic imagery.  This would be consistent with the church of Aphrodite's reclamation of her dominion over both sex and war in its series of reforms in the 70's and 80's.  A small stamped icon of a cluster of dates would seem to indicate that the sculptor was part of the Inannan denomination.

>e
You transfer your consiousness to a new group of spiders...

Beach Sculpture (in the spiders)
An east-west path runs along the Brushstroke Reservoir beach. A large complicated structure sits here, fodder for some sort of puzzle LS TBD.  To your south, you can see the playground on top of the hill.

To the southeast atop the hill is the iconic red metal structure of Coyote's Call.

>x structure
Coyote's Call is the iconic sculpture of Quinlan Park.  Made of large red metal tubes and beams, it dominates the landscape from atop the central hill to the southeast.

* * *

>x tubes
Coyote's Call is the iconic sculpture of Quinlan Park.  Made of large red metal tubes and beams, it dominates the landscape from atop the central hill to the southeast.

>e
You transfer your consiousness to a new group of spiders...

Water Sculpture (in the spiders)
Here at the northeast section of the park is a fountain-sculpture-thing in the shallow water of the reservoir.  Paths run from here south along the edge of the hill, southwest up the hill, and west along the beach.

To the southwest atop the hill is the iconic red metal structure of Coyote's Call.

>s
You transfer your consiousness to a new group of spiders...

East Hill (in the spiders)
A north-south path rises here on the lower east end of the hill.  A sculpture labeled "Bird and Cage" is displayed here; a mass of metal bits on poles.

Up the hill to the west is the iconic red metal structure of Coyote's Call.

>x bird
A set of twisted pieces of metal and stone, each sitting atop a metal pole (more LS TBD).

* * *

>x pole
A set of twisted pieces of metal and stone, each sitting atop a metal pole (more LS TBD).

>s
You transfer your consiousness to a new group of spiders...

Bewildering Bridges (in the spiders)
Three paths from the west, northwest, and north converge here at a bewildering complex of bridges, walkways, and staircases, some fixed, and some turning gently in the wind.

A ways northwest up the hill you can see the iconic red metal structure of Coyote's Call.

>x call
Coyote's Call is the iconic sculpture of Quinlan Park.  Made of large red metal tubes and beams, it dominates the landscape from atop the central hill to the northwest.

* * *

>x tubes
Coyote's Call is the iconic sculpture of Quinlan Park.  Made of large red metal tubes and beams, it dominates the landscape from atop the central hill to the northwest.

>w
You transfer your consiousness to a new group of spiders...

Sculpture By Lot (in the spiders)
The path curves from the west to the southeast here, winding through a giant sculpture that looms over the fence by the parking lot.  The main hill of the park is to the north.

Up the hill to the north is the red metal tubes and bars of Coyote's Call.

>w
You spot a spider on the west wall, and through it, move your consciousness to the spiders on the other side.

Quinlan Park Parking Lot (in the spiders)
Scattered cars fill the parking lot, including the Hyundai you came here in. The parking lot is just off of 48th street to the west.   To the north is the entrance to the park.

Looming over the parking lot to the east is a huge sculpture  whos details have yet to be decided LS TBD.}

>e
You spot a spider on the east wall, and through it, move your consciousness to the spiders on the other side.

Sculpture By Lot (in the spiders)
The path curves from the west to the southeast here, winding through a giant sculpture that looms over the fence by the parking lot.  The main hill of the park is to the north.

Up the hill to the north is the red metal tubes and bars of Coyote's Call.

>n
You transfer your consiousness to a new group of spiders...

Top of Hill (in the spiders)
From the top of the hill, you can see the entire park below you: the reservoir to the north, the playground to the west, and all eight of the permanent sculptures in the park.

A collection of giant metal tubes and beams graces the top of the hill, known as "Coyote's Call".  It's an abstract design of joyful chaos, somehow incorporating even the curve of the hill into its own expression.

>w
You transfer your consiousness to a new group of spiders...

Playground (in the spiders)
You're at the top of the hill in the park.  This side has slides, swings, and a wide variety of brightly-colored climbing equipment.  The path curves from the south to the east side of the hill, along the ridge.

Dominating the sky to the east is the red metal tubes and bars of Coyote's Call.

Kids are playing, shrieking, and chasing each other up and around the platforms.

>x kids
The kids are all having a great time. LS TBD: hint at something here.

>e
You transfer your consiousness to a new group of spiders...

Top of Hill (in the spiders)
From the top of the hill, you can see the entire park below you: the reservoir to the north, the playground to the west, and all eight of the permanent sculptures in the park.

A collection of giant metal tubes and beams graces the top of the hill, known as "Coyote's Call".  It's an abstract design of joyful chaos, somehow incorporating even the curve of the hill into its own expression.

>x coyote
Art is a converstation between the artist, the subject, and the viewer, but as you take in the tubes and spires of this particular piece, you can't help but wonder what the current Vested of Coyote would make of it.  They've not gone public, so they could be anyone.  Could they be like you, newly awakened to their abilities, trying and failing (or succeeding?) to find answers in the church dedicated to the idea they represent?  Like Lestar, so self-assured and confident, understanding and perfectly molded to their place in the world?  Like Amaia, driven to prove themselves, to surpass their forebearers?  How would that color their reponse to this giant red mass of sculpted metal?

>n
You transfer your consiousness to a new group of spiders...

Water Sculpture (in the spiders)
Here at the northeast section of the park is a fountain-sculpture-thing in the shallow water of the reservoir.  Paths run from here south along the edge of the hill, southwest up the hill, and west along the beach.

To the southwest atop the hill is the iconic red metal structure of Coyote's Call.

* * *

>z
Gently, you release your hold on time, letting it scroll forward.

A cloud passes over the sun.

* * *

>x coyote
The entire hill gave way all at once, and Coyote's Call is now falling, its original configuration lost.  But you can't help think that it was at the epicenter of the collapse.

>x people
These people are going to die if you can't figure out a way to help them.

* * *

>x man
These people are going to die if you can't figure out a way to help them.

>d
You transfer your consiousness to a new group of spiders...

Sinkhole (in the spiders)
You're partway down a giant sinkhole that apparently has been growing under the park for some time.  Everything is caught in a state of falling:  dirt, grass, the red metal pieces of Coyote's Call, and the spiders themselves.

A spear of red metal from Coyote's Call falls through open space here.

>x metal
LS TBD:  maybe some writing on it that can only be discovered in this way?

* * *

>undo
Sinkhole
You step backwards on the strands.

>u
You transfer your consiousness to a new group of spiders...

Giant Pit (in the spiders)
The entire hill has collapsed in on itself, revealing a giant pit underneath. Bushes and trees are frozen mid-fall, as they pitch forward into the yawning chasm.

People are caught frozen in time but doomed:  a stumbling woman falling forward into the hole; a man clinging desperately to a cylinder of Coyote's Call as he and the cylinder plunge into the abyss.

Coyote's Call is collapsing into the sinkhole along with everything else.  Frozen in time, the new configuration of its tubes and beams makes it seem even more joyfully chaotic.  You are probably the only person who will ever experience it this way, and it makes the combination of destruction and art intensely personal.

>z
Anchoring your consciousness in the few spiders that aren't falling into the pit or drifting away on the wind, you release your hold on time once more.  You still aren't prepared for the immediate cacophany of wrenching metal and screaming people plunging into the depths of the abyss beneath you.

With a final groan, the last spear of Coyote's Call is carried with the dirt it was anchored in an cartwheels into the abyss.  One final person, struggling against the avalances of dirt, is suddenly swept downward into the sinkhole.

* * *

>x people
These people are going to die if you can't figure out a way to help them.

>x coyote
Somehow, the artistic chaos from before has been dissapated into just... normal chaos.  It's now just a pile of falling red metal.

>z
As you release your hold on time, the last of the top of the hill falls past you into the deep.

From somewhere in the non-destroyed park, you hear an announcement being made.

The sun emerges again from behind the cloud.

>u
You transfer your consiousness to a new group of spiders...

Giant Pit (in the spiders)
The entire hill has collapsed in on itself, revealing a giant pit underneath. Bushes and trees are frozen mid-fall, as they pitch forward into the yawning chasm.

>e
You transfer your consiousness to a new group of spiders...

East Hill (in the spiders)
A north-south path rises here on the lower east end of the hill.  A sculpture labeled "Bird and Cage" is displayed here; a mass of metal bits on poles.

Much of the hill to the west is missing, including Coyote's call.

>z
Gently, you release your hold on time, letting it scroll forward.

LS TBD:  the sinkhole expands.

* * *

>undo
Sinkhole
You step backwards on the strands.

>u
You transfer your consiousness to a new group of spiders...

Giant Pit (in the spiders)
The entire hill has collapsed in on itself, revealing a giant pit underneath. Bushes and trees are frozen mid-fall, as they pitch forward into the yawning chasm.

* * *

>e
You transfer your consiousness to a new group of spiders...

East Hill (in the spiders)
A north-south path rises here on the lower east end of the hill.  A sculpture labeled "Bird and Cage" is displayed here; a mass of metal bits on poles.

Much of the hill to the west is missing, including Coyote's call.

>z
Gently, you release your hold on time, letting it scroll forward.

With a squawk, hidden speakers come to life, and you hear Jace say, "Um, hi, I guess the park is... closed?  Everyone should get out, at least.  If you can!  If you can't, um, sorry, I'll see if I can get help.  I'll do that next.  But, like, right now, everyone else leave, so you don't, like, fall in the hole."

The sun emerges again from behind the cloud.

>sw
You transfer your consiousness to a new group of spiders...

Bewildering Bridges (in the spiders)
Three paths from the west, northwest, and north converge here at a bewildering complex of bridges, walkways, and staircases, some fixed, and some turning gently in the wind.

Coyote's Call has disappeared from view; it used to be visible to the northwest.

>w
You transfer your consiousness to a new group of spiders...

Sculpture By Lot (in the spiders)
The path curves from the west to the southeast here, winding through a giant sculpture that looms over the fence by the parking lot.  The main hill of the park is to the north.

Bits of the Coyote's Call structure can still be seen as it falls into the sinkhole.

>nw
You transfer your consiousness to a new group of spiders...

Plaza (in the spiders)
Paths run through this plaza from the south entrance, then splitting northwest around the hill, north up the hill, and east along it. 

To the northeast, the iconic red metal of Coyote's Call is no longer visible.

Prominently displayed just inside the entrance is some sort of sculpture (LS TBD).

>s
You transfer your consiousness to a new group of spiders...

Quinlan Park Entrance (in the spiders)
Two booths flank the entrance to the park to the north, where you can buy tickets and get information.  To the south is the parking lot.

You can see Jace manning the ticket booth, but the information booth is empty.

>enter jace
Yup!  This'll be a thing! -LS TBD.

>z
Gently, you release your hold on time, letting it scroll forward.

LS TBD:  the sinkhole expands.

* * *

>z
Gently, you release your hold on time, letting it scroll forward.

>z
Gently, you release your hold on time, letting it scroll forward.

You see Jace pull a hand-held microphone off the wall of the ticket booth.

With a squawk, hidden speakers come to life, and you hear Jace say, "Oh shit everyone get out!  911's on their way but that hole's getting larger!  Parking lot, everyone!"

>z
Gently, you release your hold on time, letting it scroll forward.

Jace gets out of the ticket booth.

* * *

>z
Gently, you release your hold on time, letting it scroll forward.

Jace goes south.

>s
You transfer your consiousness to a new group of spiders...

Quinlan Park Parking Lot (in the spiders)
Scattered cars fill the parking lot, including the Hyundai you came here in. The parking lot is just off of 48th street to the west.   To the north is the entrance to the park.

Looming over the parking lot to the east is a huge sculpture  whos details have yet to be decided LS TBD.}

You can also see Jace here.

>z
Gently, you release your hold on time, letting it scroll forward.

>z
Gently, you release your hold on time, letting it scroll forward.

You feel the web of time time tighten beneath you, and with a rush, you slip backwards along it before it finally goes slack again, and you regain your hold.

Quinlan Park Parking Lot (in the spiders)
Scattered cars fill the parking lot, but your Hyundai hasn't arrived yet. The parking lot is just off of 48th street to the west.   To the north is the entrance to the park.

Looming over the parking lot to the east is a huge sculpture  whos details have yet to be decided LS TBD.}

* * *

>x man
These people are going to die if you can't figure out a way to help them.

>showme top of hill
Giant Pit - room
    disaster_victims - person
    spiders - person
        yourself - woman
            disaster memory - memory
    Coyote's Call
lighted, visited; singular-named, proper-named
description: "The entire hill has collapsed in on itself, revealing a giant pit underneath. Bushes and trees are frozen mid-fall, as they pitch forward into the yawning chasm."
room condition: chasmy
printed name: "Giant Pit"
printed plural name: none
indefinite article: none
list grouping key: none