Amaia screeches into the parking lot, and expertly zips into an open spot.  She closes her eyes briefly, checking, then opens them again, only fractionally less concerned.  "OK," she says, breathlessly, "whatever it is that's going to happen hasn't happened yet.  Zora," she turns to you apologetically over her shoulder, "you won't have a lot of time, but the future's still branching, so it should be enough.  Lestar, you're up." 

From the passenger seat, Lestar grins at both of you, his white eyebrows quirking soothingly, and he reaches behind his seat to pat you reassuringly on the arm.  "You got this, kid," he says "You've been doing great; this'll be just like the other times."  From Amaia's panicked expression, you can tell she disagrees, but she says nothing.  You take a deep breath and grab Lestar's hand, dry and warm, and it grounds you.

Amaia takes Lestar's other hand, then grabs yours, the contact sleek with sweat from both of you.  Lestar nods at you both, and closes his eyes.

Everything freezes.

You have all the time in the world.

Fate's Gallery
An Interactive Story by Lucian Smith
Release 0 / Serial number 240611 / Inform 7 v10.1.2 / D

Quinlan Park Parking Lot (in the Hyundai)
Scattered cars fill the parking lot, including the Hyundai you came here in. The parking lot is just off of 48th street to the west.   To the north is the entrance to the park.

Looming over the parking lot to the east is a huge sculpture  whose details have yet to be decided LS TBD.}

Amaia is turned sideways in the driver's seat, grasping your hand and Lestar's.  Even frozen, she radiates intensity and movement.

Lestar's eyes are shut in calm concentration.  His relaxed hands hold yours and Amaia's, completing the triangle.

In the area, you can sense the collective presence of dozens of spiders.

>enter spiders
With practiced ease, you move your consciousness out of your own head, and into the surrounding spiders.  Your perception shifts, and you see the parking lot as if you were standing in it, though patched together from dozens of small views.

Quinlan Park Parking Lot (in the spiders)
Scattered cars fill the parking lot, including the Hyundai you came here in. The parking lot is just off of 48th street to the west.   To the north is the entrance to the park.

Looming over the parking lot to the east is a huge sculpture  whose details have yet to be decided LS TBD.}

>n
You transfer your consciousness to a new group of spiders...

Quinlan Park Entrance (in the spiders)
Two booths flank the entrance to the park to the north, where you can buy tickets and get information.  To the south is the parking lot.

You can see a young man manning the ticket booth, but the information booth is empty.

>n
You transfer your consciousness to a new group of spiders...

Plaza (in the spiders)
Paths run through this plaza from the south entrance, then splitting northwest around the hill, north up the hill, and east along it. 

To the northeast atop the hill is the iconic red metal structure of Coyote's Call.

Prominently displayed just inside the entrance is some sort of sculpture (LS TBD).

>n
You transfer your consciousness to a new group of spiders...

Playground (in the spiders)
You're at the top of the hill in the park.  This side has slides, swings, and a wide variety of brightly-colored climbing equipment.  The path curves from the south to the east side of the hill, along the ridge.

Dominating the sky to the east are the red metal tubes and bars of Coyote's Call.

Kids are playing, shrieking, and chasing each other up and around the platforms.

Whatever Amaia is worried about is apparently happening in this park.  You'll need to wait to advance the loop and see what's going on.

>e
You transfer your consciousness to a new group of spiders...

Top of Hill (in the spiders)
From the top of the hill, you can see the entire park below you: the reservoir to the north, the playground to the west, and all eight of the permanent sculptures in the park.

A collection of giant metal tubes and beams graces the top of the hill, known as "Coyote's Call".  It's an abstract design of joyful chaos, somehow incorporating even the curve of the hill into its own expression.

>z
Gently, you release your hold on time, letting it scroll forward.

>z
Gently, you release your hold on time, letting it scroll forward.

You feel an ominous rumbling from deep under the earth.

* * *

>d
You transfer your consciousness to a new group of spiders...

Sinkhole (in the spiders)
You're partway down a giant sinkhole that apparently has been growing under the park for some time.  Everything is caught in a state of falling:  dirt, grass, the red metal pieces of Coyote's Call, and the spiders themselves.

A spear of red metal from Coyote's Call falls through open space here.

>gonear scarf
Void
This is the off-stage area of the game.

You also sense the presence of another mind nearby--maybe a kid?  You can't see them, though.

Somehow, you never directly noticed the fourth passerby before, but now that you know she was there, you can mostly see her in your memory.

You can also see hiding memory, mysterious design memory, jace1_announce, jace2_announce, and jace3_announce here.

>x scarf
Focusing intently on your memory, you think you can make out a design on the scarf: two crossed lines circumscribed by a rounded triangle.

>gonear spear
(mysterious design memory)
Void
This is the off-stage area of the game.

Coyote's Call is collapsing into the sinkhole along with everything else.

You also sense the presence of another mind nearby--maybe a kid?  You can't see them, though.

Somehow, you never directly noticed the fourth passerby before, but now that you know she was there, you can mostly see her in your memory.

You can also see hiding memory, mysterious design memory, jace1_announce, jace2_announce, and jace3_announce here.

With a squawk, hidden speakers come to life, and you hear a young man say, "Um, hi, I guess the park is... closed?  Everyone should get out, at least.  If you can!  If you can't, um, sorry, I'll see if I can get help.  I'll do that next.  But, like, right now, everyone else should leave."

The young boy waits.

The sun emerges again from behind the cloud.

>x spear
A snapshot in your mind of the odd design you saw on both the spear of metal from Coyote's Call and the scarf of the hidden woman from your first mission.  It's two crossed lines circumscribed by a rounded triangle.

>restart
Are you sure you want to restart?

>y
Amaia screeches into the parking lot, and expertly zips into an open spot.  She closes her eyes briefly, checking, then opens them again, only fractionally less concerned.  "OK," she says, breathlessly, "whatever it is that's going to happen hasn't happened yet.  Zora," she turns to you apologetically over her shoulder, "you won't have a lot of time, but the future's still branching, so it should be enough.  Lestar, you're up." 

From the passenger seat, Lestar grins at both of you, his white eyebrows quirking soothingly, and he reaches behind his seat to pat you reassuringly on the arm.  "You got this, kid," he says "You've been doing great; this'll be just like the other times."  From Amaia's panicked expression, you can tell she disagrees, but she says nothing.  You take a deep breath and grab Lestar's hand, dry and warm, and it grounds you.

Amaia takes Lestar's other hand, then grabs yours, the contact sleek with sweat from both of you.  Lestar nods at you both, and closes his eyes.

Everything freezes.

You have all the time in the world.

Fate's Gallery
An Interactive Story by Lucian Smith
Release 0 / Serial number 240611 / Inform 7 v10.1.2 / D

Quinlan Park Parking Lot (in the Hyundai)
Scattered cars fill the parking lot, including the Hyundai you came here in. The parking lot is just off of 48th street to the west.   To the north is the entrance to the park.

Looming over the parking lot to the east is a huge sculpture  whose details have yet to be decided LS TBD.}

Amaia is turned sideways in the driver's seat, grasping your hand and Lestar's.  Even frozen, she radiates intensity and movement.

Lestar's eyes are shut in calm concentration.  His relaxed hands hold yours and Amaia's, completing the triangle.

In the area, you can sense the collective presence of dozens of spiders.

>gonear scarf
Void
This is the off-stage area of the game.

The majority of Coyote's Call is caught frozen near you as it tumbles.

You also sense the presence of another mind nearby--maybe a kid?  You can't see them, though.

Somehow, you never directly noticed the fourth passerby before, but now that you know she was there, you can mostly see her in your memory.

.

You can also see your consciousness, disaster memory, hiding memory, mysterious design memory, jace1_announce, jace2_announce, and jace3_announce here.

>x scarf
Focusing intently on your memory, you think you can make out a design on the scarf: two crossed lines circumscribed by a rounded triangle.

>gonear hyundai
Quinlan Park Parking Lot
Scattered cars fill the parking lot, including the Hyundai you came here in. The parking lot is just off of 48th street to the west.   To the north is the entrance to the park.

Looming over the parking lot to the east is a huge sculpture  whose details have yet to be decided LS TBD.}

>enter spiders
With practiced ease, you move your consciousness out of your own head, and into the surrounding spiders.  Your perception shifts, and you see the parking lot as if you were standing in it, though patched together from dozens of small views.

Quinlan Park Parking Lot (in the spiders)
Scattered cars fill the parking lot, including the Hyundai you came here in. The parking lot is just off of 48th street to the west.   To the north is the entrance to the park.

Your own face relaxes as you look at yourself from the outside.  Somehow, it's easier to see yourself this way than in the mirror.

Looming over the parking lot to the east is a huge sculpture  whose details have yet to be decided LS TBD.}

>n
You transfer your consciousness to a new group of spiders...

Quinlan Park Entrance (in the spiders)
Two booths flank the entrance to the park to the north, where you can buy tickets and get information.  To the south is the parking lot.

You can see a young man manning the ticket booth, but the information booth is empty.

* * *

>n
You transfer your consciousness to a new group of spiders...

Plaza (in the spiders)
Paths run through this plaza from the south entrance, then splitting northwest around the hill, north up the hill, and east along it. 

To the northeast atop the hill is the iconic red metal structure of Coyote's Call.

Prominently displayed just inside the entrance is some sort of sculpture (LS TBD).

>ne
You transfer your consciousness to a new group of spiders...

Top of Hill (in the spiders)
From the top of the hill, you can see the entire park below you: the reservoir to the north, the playground to the west, and all eight of the permanent sculptures in the park.

A collection of giant metal tubes and beams graces the top of the hill, known as "Coyote's Call".  It's an abstract design of joyful chaos, somehow incorporating even the curve of the hill into its own expression.

Whatever Amaia is worried about is apparently happening in this park.  You'll need to wait to advance the loop and see what's going on.

>z
Gently, you release your hold on time, letting it scroll forward.

* * *

>d
You transfer your consciousness to a new group of spiders...

Sinkhole (in the spiders)
You're partway down a giant sinkhole that apparently has been growing under the park for some time.  Everything is caught in a state of falling:  dirt, grass, the red metal pieces of Coyote's Call, and the spiders themselves.

A spear of red metal from Coyote's Call falls through open space here.

>x spear
Etched into the base of the spear is a design that must have been buried in the dirt:  two crossed lines circumscribed by a rounded triangle.

Wait.  That's the same design that you finally remembered from the purple scarf of the hidden woman outside the office complex from your first mission.

>x spear
(falling pieces of Coyote's Call)
Etched into the base of the spear is a design that must have been buried in the dirt:  two crossed lines circumscribed by a rounded triangle.  It's definitely the same design that you remembered from the hidden woman outside the office complex.

>i
You are carrying:
  mysterious design memory
  disaster memory

>x spear memory
A snapshot in your mind of the odd design you saw on both the spear of metal from Coyote's Call and the scarf of the hidden woman from your first mission.  It's two crossed lines circumscribed by a rounded triangle.

>x design memory
A snapshot in your mind of the odd design you saw on both the spear of metal from Coyote's Call and the scarf of the hidden woman from your first mission.  It's two crossed lines circumscribed by a rounded triangle.

>x design
A snapshot in your mind of the odd design you saw on both the spear of metal from Coyote's Call and the scarf of the hidden woman from your first mission.  It's two crossed lines circumscribed by a rounded triangle.

* * *

>d
You transfer your consciousness to a new group of spiders...

Sinkhole (in the spiders)
You're partway down a giant sinkhole that apparently has been growing under the park for some time.  Everything is caught in a state of falling:  dirt, grass, the red metal pieces of Coyote's Call, and the spiders themselves.

A spear of red metal from Coyote's Call falls through open space here.

>x spear
Etched into the base of the spear is a design that must have been buried in the dirt:  two crossed lines circumscribed by a rounded triangle.

>gonear scarf
Void
This is the off-stage area of the game.

You also sense the presence of another mind nearby--maybe a kid?  You can't see them, though.

Somehow, you never directly noticed the fourth passerby before, but now that you know she was there, you can mostly see her in your memory.

You can also see hiding memory, jace1_announce, jace2_announce, and jace3_announce here.

>x scarf
Focusing intently on your memory, you think you can make out a design on the scarf: two crossed lines circumscribed by a rounded triangle.  

Wait.  That's the same design that you saw on the spear of metal from Coyote's Call.

>x scarf
Focusing intently on your memory, you think you can make out a design on the scarf: two crossed lines circumscribed by a rounded triangle.  It's definitely the same design that you saw on the unearthed base of the bit of Coyote's Call you caught as it plunged into the sinkhole.

* * *

>x spear
Etched into the base of the spear is a design that must have been buried in the dirt:  two crossed lines circumscribed by a rounded triangle.

>showme spear
falling_coyote - thing
location: in Sinkhole
unlit, inedible, portable; singular-named, proper-named; processed
description: "Etched into the base of the spear is a design that must have been buried in the dirt:  two crossed lines circumscribed by a rounded triangle."
initial appearance: "A spear of red metal from Coyote's Call falls through open space here."
printed name: "falling_coyote"
printed plural name: none
indefinite article: none
list grouping key: none

>showme scarf
purple scarf - thing
location: carried by the mysterious woman in Void
unlit, inedible, portable; singular-named, improper-named; description: "Focusing intently on your memory, you think you can make out a design on the scarf: two crossed lines circumscribed by a rounded triangle.  

Wait.  That's the same design that you saw on the spear of metal from Coyote's Call.
"
initial appearance: none
printed name: "purple scarf"
printed plural name: none
indefinite article: none
list grouping key: none

* * *

>n
You transfer your consciousness to a new group of spiders...

Beach Sculpture (in the spiders)
An east-west path runs along the Brushstroke Reservoir beach. A large complicated structure sits here, fodder for some sort of puzzle LS TBD.  To your south, you can see the playground on top of the hill.

To the southeast atop the hill is the iconic red metal structure of Coyote's Call.

>s
You transfer your consciousness to a new group of spiders...

Playground (in the spiders)
You're at the top of the hill in the park.  This side has slides, swings, and a wide variety of brightly-colored climbing equipment.  The path curves from the south to the east side of the hill, along the ridge.

Dominating the sky to the east are the red metal tubes and bars of Coyote's Call.

Kids are playing, shrieking, and chasing each other up and around the platforms.

* * *

>l
Quinlan Park Parking Lot (in the Hyundai)
Scattered cars fill the parking lot, including the Hyundai you came here in. The parking lot is just off of 48th street to the west.   To the north is the entrance to the park.

Looming over the parking lot to the east is a huge sculpture  whose details have yet to be decided LS TBD.}

Amaia is turned sideways in the driver's seat, grasping your hand and Lestar's.  Even frozen, she radiates intensity and movement.

Lestar's eyes are shut in calm concentration.  His relaxed hands hold yours and Amaia's, completing the triangle.

In the area, you can sense the collective presence of dozens of spiders.

the player is yourself.

>l
Quinlan Park Parking Lot (in the Hyundai)
Scattered cars fill the parking lot, including the Hyundai you came here in. The parking lot is just off of 48th street to the west.   To the north is the entrance to the park.

Looming over the parking lot to the east is a huge sculpture  whose details have yet to be decided LS TBD.}

Amaia is turned sideways in the driver's seat, grasping your hand and Lestar's.  Even frozen, she radiates intensity and movement.

Lestar's eyes are shut in calm concentration.  His relaxed hands hold yours and Amaia's, completing the triangle.

In the area, you can sense the collective presence of dozens of spiders.

[** Programming error: tried to read (something) **]

* * *

>n
While frozen, you can enter the minds around you, and you're aware of your surroundings, but can't do anything physical.

>enter spiders
With practiced ease, you move your consciousness out of your own head, and into the surrounding spiders.  Your perception shifts, and you see the parking lot as if you were standing in it, though patched together from dozens of small views.

Quinlan Park Parking Lot (in the spiders)
Scattered cars fill the parking lot, including the Hyundai you came here in. The parking lot is just off of 48th street to the west.   To the north is the entrance to the park.

Looming over the parking lot to the east is a huge sculpture  whose details have yet to be decided LS TBD.}

* * *

>z
Gently, you release your hold on time, letting it scroll forward.

>z
Gently, you release your hold on time, letting it scroll forward.

A cloud passes over the sun.

>z
Gently, you release your hold on time, letting it scroll forward.

* * *

>sw
You transfer your consciousness to a new group of spiders...

Plaza (in the spiders)
Paths run through this plaza from the south entrance, then splitting northwest around the hill, north up the hill, and east along it. 

To the northeast, the iconic red metal of Coyote's Call is no longer visible.

Prominently displayed just inside the entrance is some sort of sculpture (LS TBD).

>s
You transfer your consciousness to a new group of spiders...

Quinlan Park Entrance (in the spiders)
Two booths flank the entrance to the park to the north, where you can buy tickets and get information.  To the south is the parking lot.

You can see a young man manning the ticket booth, but the information booth is empty.

>enter man
Gathering your thoughts together, you leave the spiders and transfer your consciousness into the young man.

Quinlan Park Entrance (in the young man) (in the ticket booth)
Two booths flank the entrance to the park to the north, where you can buy tickets and get information.  To the south is the parking lot.

In the area, you can sense the collective presence of dozens of spiders.

You take a deep (metaphorical) breath.  You've put it off as long as you could, but if you're going to be able to do anything here, this is the only way.

You let go of time, and enter Jace's mind instead.

You hunker down mentally as Jace's consciousness and yours intertwine.  You've trained enough that you can give Jace some mental privacy, but untrained, he immediately carreens painfully through your thoughts and memories following connections that happen to resonate, and you're pulled along. 

                                                *    *    *

You're racing to the park, Amaia in the throes of a prophecy but expertly navigating through traffic anyway; her hands in a death lock on the steering wheel of the Hyundai-- 

                                                *    *    *

The Hyundai looking so...normal, sitting in your high school's the parking lot as you and your parents approach the intense woman and old man standing next to it, here because...

1) oh no
2) Try to break the connection.

>1
[oh no]

                                                *    *    *

Homework finished, you're gazing across the room at Duncan, and his hair, and his shoulders, and the way he laughs, and your mind starts to wander, and then your mind starts to ACTUALLY WANDER and

1) "Jace, no!"
2) Try to break the connection.

>1
["Jace, no!"]

and you're suddenly READING EACH OTHERS MINDS and he KNOWS and Oh, geez, I'm so sorry I don't even HORRIFIED and SCARED and sees you across the room eyes glazed over Who even are you and how and yells

1) Try to explain.
2) Try to break the connection.

* * *

>1
[Show him the memory of the sinkhole.]

You show Jace the snapshot in your mind of the sinkhole.

This is as far as I've gotten!  Suggestions welcome.  Still need to implement the end of the conversation, then the mechanics of doing-stuff-while-in-Jace's-head.  (So don't bother testing that; not much will work correctly yet.)

Quinlan Park Entrance (in Jace) (in the ticket booth)
Two booths flank the entrance to the park to the north, where you can buy tickets and get information.  To the south is the parking lot.

In the area, you can sense the collective presence of dozens of spiders.

>z
Time passes.

>z
Time passes.

You see Jace pull a hand-held microphone off the wall of the ticket booth.

With a squawk, hidden speakers come to life, and you hear Jace say, "Um, hi, I guess the park is... closed?  Everyone should get out, at least.  If you can!  If you can't, um, sorry, I'll see if I can get help.  I'll do that next.  But, like, right now, everyone else should leave."

The sun emerges again from behind the cloud.

>z
Time passes.

LS TBD:  the sinkhole expands.

>z
Time passes.

>z
Time passes.

You see Jace pull a hand-held microphone off the wall of the ticket booth.

With a squawk, hidden speakers come to life, and you hear Jace say, "Oh shit everyone get out!  911's on their way but that hole's getting larger!  Parking lot, everyone!"

>z
Time passes.

Jace gets out of the ticket booth.

>z
Time passes.

Jace goes south.

>z
Time passes.

>z
Time passes.

You feel the web of time time tighten beneath you, and with a rush, you slip backwards along it before it finally goes slack again, and you regain your hold.

Quinlan Park Entrance (in Jace) (in the ticket booth)
Two booths flank the entrance to the park to the north, where you can buy tickets and get information.  To the south is the parking lot.

In the area, you can sense the collective presence of dozens of spiders.

You've gone to the beginning of the loop while in Jace's mind.  You can start a new conversation with them like the first time you entered their mind, or we can skip that part and say you have the same conversation with them this time that you had last time.

1) Start a new conversation with them.
2) Repeat the conversation you had with them the last time.

>2
[Repeat the conversation you had with them the last time.]

You go through the same conversation you had with them last time.

Quinlan Park Entrance (in Jace) (in the ticket booth)
Two booths flank the entrance to the park to the north, where you can buy tickets and get information.  To the south is the parking lot.

In the area, you can sense the collective presence of dozens of spiders.

>undo
Quinlan Park Entrance
You step backwards on the strands.

>1
[Start a new conversation with them.]

You take a deep (metaphorical) breath.  You've put it off as long as you could, but if you're going to be able to do anything here, this is the only way.

You let go of time, and enter Jace's mind instead.

You hunker down mentally as Jace's consciousness and yours intertwine.  You've trained enough that you can give Jace some mental privacy, but untrained, he immediately carreens painfully through your thoughts and memories following connections that happen to resonate, and you're pulled along. 

                                                *    *    *

You're racing to the park, Amaia in the throes of a prophecy but expertly navigating through traffic anyway; her hands in a death lock on the steering wheel of the Hyundai-- 

                                                *    *    *

The Hyundai looking so...normal, sitting in your high school's the parking lot as you and your parents approach the intense woman and old man standing next to it, here because...

1) oh no
2) Try to break the connection.

You take a deep (metaphorical) breath.  You've put it off as long as you could, but if you're going to be able to do anything here, this is the only way.

You let go of time, and enter Jace's mind instead.

You hunker down mentally as Jace's consciousness and yours intertwine.  You've trained enough that you can give Jace some mental privacy, but untrained, he immediately carreens painfully through your thoughts and memories following connections that happen to resonate, and you're pulled along. 

                                                *    *    *

You're racing to the park, Amaia in the throes of a prophecy but expertly navigating through traffic anyway; her hands in a death lock on the steering wheel of the Hyundai-- 

                                                *    *    *

The Hyundai looking so...normal, sitting in your high school's the parking lot as you and your parents approach the intense woman and old man standing next to it, here because...

1) oh no
2) Try to break the connection.

>undo
Quinlan Park Entrance
You step backwards on the strands.

>rules
Rules tracing now switched on. Type "rules off" to switch it off again, or "rules all" to include even rules which do not apply.

[Rule "parse command rule" applies.]

* * *

>x amaia
Amaia is a tall dark-haired woman with piercing but tired brown eyes.

* * *

>touch spiders
The surface thoughts of the spiders are entirely instinctual, and refreshing in their simplicity.  You feel your own emotions being acknowledged in return, without them affecting the spiders in the slightest.

>enter spiders
With practiced ease, you move your consciousness out of your own head, and into the surrounding spiders.  Your perception shifts, and you see the parking lot as if you were standing in it, though patched together from dozens of small views.

Quinlan Park Parking Lot (in the spiders)
Scattered cars fill the parking lot, including the Hyundai you came here in. The parking lot is just off of 48th street to the west.   To the north is the entrance to the park.

Looming over the parking lot to the east is a huge sculpture  whose details have yet to be decided LS TBD.}

>x sculpture
It's a sculpture looming over the east fence LS TBD.

>n
You transfer your consciousness to a new group of spiders...

Quinlan Park Entrance (in the spiders)
Two booths flank the entrance to the park to the north, where you can buy tickets and get information.  To the south is the parking lot.

You can see a young man manning the ticket booth, but the information booth is empty.

* * *

>touch jace
You'll have to enter his mind at some point, but you don't know why yet, or how he could help.  Until you do, you need to do more reconnaisance.

>enter ticket
That's not something you can enter.

>enter ticket booth
That's not something you can enter.

>enter information booth
That's not something you can enter.

>out
You can't exit one consciousness without going into another one.

>out
You can't exit one consciousness without going into another one.

* * *

>x innanan
As you examine the twisted metal from different angles, you can almost imagine you see both swords and erotic imagery.  This would be consistent with the church of Aphrodite's reclamation of her dominion over both sex and war in its series of reforms in the 70's and 80's.  A small stamped icon of a cluster of dates would seem to indicate that the sculptor was part of the Inannan denomination.

>e
You transfer your consciousness to a new group of spiders...

Beach Sculpture (in the spiders)
An east-west path runs along the Brushstroke Reservoir beach. A large complicated structure sits here, fodder for some sort of puzzle LS TBD.  To your south, you can see the playground on top of the hill.

To the southeast atop the hill is the iconic red metal structure of Coyote's Call.

>x structure
Coyote's Call is the iconic sculpture of Quinlan Park.  Made of large red metal tubes and beams, it dominates the landscape from atop the central hill to the southeast.

* * *

>w
You transfer your consciousness to a new group of spiders...

Sculpture By Lot (in the spiders)
The path curves from the west to the southeast here, winding through a giant sculpture that looms over the fence by the parking lot.  The main hill of the park is to the north.

Up the hill to the north are the red metal tubes and bars of Coyote's Call.

>w
You spot a spider on the west wall, and through it, move your consciousness to the spiders on the other side.

Quinlan Park Parking Lot (in the spiders)
Scattered cars fill the parking lot, including the Hyundai you came here in. The parking lot is just off of 48th street to the west.   To the north is the entrance to the park.

Looming over the parking lot to the east is a huge sculpture  whose details have yet to be decided LS TBD.}

>e
You spot a spider on the east wall, and through it, move your consciousness to the spiders on the other side.

Sculpture By Lot (in the spiders)
The path curves from the west to the southeast here, winding through a giant sculpture that looms over the fence by the parking lot.  The main hill of the park is to the north.

Up the hill to the north are the red metal tubes and bars of Coyote's Call.

* * *

>w
You transfer your consciousness to a new group of spiders...

Playground (in the spiders)
You're at the top of the hill in the park.  This side has slides, swings, and a wide variety of brightly-colored climbing equipment.  The path curves from the south to the east side of the hill, along the ridge.

Dominating the sky to the east are the red metal tubes and bars of Coyote's Call.

Kids are playing, shrieking, and chasing each other up and around the platforms.

>e
You transfer your consciousness to a new group of spiders...

Top of Hill (in the spiders)
From the top of the hill, you can see the entire park below you: the reservoir to the north, the playground to the west, and all eight of the permanent sculptures in the park.

A collection of giant metal tubes and beams graces the top of the hill, known as "Coyote's Call".  It's an abstract design of joyful chaos, somehow incorporating even the curve of the hill into its own expression.

>z
Gently, you release your hold on time, letting it scroll forward.

You feel an ominous rumbling from deep under the earth.

* * *

>x spear
Etched into the base of the spear is a design that must have been buried in the dirt:  two crossed lines circumscribed by a rounded triangle.

>showme scarf
purple scarf - thing
location: carried by the mysterious woman in Void
unlit, inedible, portable; singular-named, improper-named; description: "Focusing intently on your memory, you think you can make out a design on the scarf: two crossed lines circumscribed by a rounded triangle.  It's definitely the same design that you saw on the unearthed base of the bit of Coyote's Call you caught as it plunged into the sinkhole.
"
initial appearance: none
printed name: "purple scarf"
printed plural name: none
indefinite article: none
list grouping key: none

>showme spear
falling_coyote - thing
location: in Sinkhole
unlit, inedible, portable; singular-named, proper-named; processed
description: "Etched into the base of the spear is a design that must have been buried in the dirt:  two crossed lines circumscribed by a rounded triangle.  It's definitely the same design that you remembered from the hidden woman outside the office complex.
"
initial appearance: "A spear of red metal from Coyote's Call falls through open space here."
printed name: "falling_coyote"
printed plural name: none
indefinite article: none
list grouping key: none

* * *

>d
You transfer your consciousness to a new group of spiders...

Sinkhole (in the spiders)
You're partway down a giant sinkhole that apparently has been growing under the park for some time.  Everything is caught in a state of falling:  dirt, grass, the red metal pieces of Coyote's Call, and the spiders themselves.

A spear of red metal from Coyote's Call falls through open space here.

>x metal
LS TBD:  maybe some writing on it that can only be discovered in this way?

>x people
You can't see any such thing.

* * *

>z
Gently, you release your hold on time, letting it scroll forward.

>z
Gently, you release your hold on time, letting it scroll forward.

You feel the web of time time tighten beneath you, and with a rush, you slip backwards along it before it finally goes slack again, and you regain your hold.

Quinlan Park Entrance (in the spiders)
Two booths flank the entrance to the park to the north, where you can buy tickets and get information.  To the south is the parking lot.

You can see Jace manning the ticket booth, but the information booth is empty.

>enter jace
Gathering your thoughts together, you leave the spiders and transfer your consciousness into Jace.

Quinlan Park Entrance (in Jace) (in the ticket booth)
Two booths flank the entrance to the park to the north, where you can buy tickets and get information.  To the south is the parking lot.

In the area, you can sense the collective presence of dozens of spiders.

You hunker down mentally as Jace's consciousness and yours intertwine.  You've trained enough that you can give Jace some mental privacy, but untrained, he immediately carreens painfully through your thoughts and memories following connections that happen to resonate, and you're pulled along. 

                                                                       *    *    *

You're racing to the park, Amaia in the throes of a prophecy but expertly navigating through traffic anyway; her hands in a death lock on the steering wheel of the Hyundai-- 

                                                                       *    *    *

The Hyundai looking so...normal, sitting in your high school's the parking lot as you and your parents approach the intense woman and old man standing next to it, here because...

1) oh no
2) Try to break the connection.

>1
[oh no]

                                                                       *    *    *

Homework finished, you're gazing across the room at Duncan, and his hair, and his shoulders, and the way he laughs, and your mind starts to wander, and then your mind starts to ACTUALLY WANDER and

1) "Jace, no!"
2) Try to break the connection.

>undo
Quinlan Park Entrance
You step backwards on the strands.

>2
[Try to break the connection.]

You continue to be swept along in your memory.
                                                                       *    *    *

Homework finished, you're gazing across the room at Duncan, and his hair, and his shoulders, and the way he laughs, and your mind starts to wander, and then your mind starts to ACTUALLY WANDER and

1) "Jace, no!"
2) Try to break the connection.

>1
["Jace, no!"]

and you're suddenly READING EACH OTHERS MINDS and he KNOWS and Oh, geez, I'm so sorry I don't even HORRIFIED and SCARED and sees you across the room eyes glazed over Who even are you and how and yells

1) Try to explain.
2) Try to break the connection.

* * *

>l
You continue to be swept along in your memory.
and you're suddenly READING EACH OTHERS MINDS and he KNOWS and Oh, geez, I'm so sorry I don't even HORRIFIED and SCARED and sees you across the room eyes glazed over Who even are you and how and yells

1) Try to explain.
2) Try to break the connection.

>2
[Try to break the connection.]

You continue to be swept along in your memory.

yells "Zora!" and you finally snap back to yourself again, and everyone's looking at Duncan and Duncan is looking at you and your eyes plead but he smirks Oh, geez, I'm so sorry, I don't need to see this, I should be--

                                                                       *    *    *

You're in a meadow by a lake, your consciousness distributed in hundreds of spiders, letting time slip by, and totally at peace.  A breeze plays across the meadow and you feel it in each web in turn.

1) Appreciate the meadow for a bit.
2) "Jace, I need your help."

>1
[Appreciate the meadow for a bit.]

Jace quietly waits in the memory of the meadow with you.  His excitement and wonder leak everywhere, making the memory not quite as calming as it usually is.  It's still a nice break from reliving the most embarassing moment of your entitre life, so there's that.

Finally, you speak.  Thanks for finding this place.  There aren't many who find their way here, so it's nice.

I... assume there aren't many who find their way to "the most embarassing moment of your life", either, so sorry about that, Jace responds.  Which means he's one of the people who also hears your inner monologue.  Yeah, he confirms.   Well, OK, then.

You both appreciate the meadow for a bit more.  So, you're a Vested?  Jace asks.  Power of the ancients, passed on to the next-born for thousands of years?  Feeling confirmation from you, he can't contain his delight.  That's so cool!  And you can go into people's heads!  And into spider's heads!  I can't even imagine how you manage to stitch together a coherent perspective from all of them at once.  I've read stories, of course, but none of them even hinted at abilities like this!

1) "It's not actually that glamourous."
2) "Jace, I need your help."

* * *

>z
Time passes.

>reset
You feel the web of time time tighten beneath you, and with a rush, you slip backwards along it before it finally goes slack again, and you regain your hold.

You've gone to the beginning of the loop while in Jace's mind.  You can repeat the conversation you had with them the last time, or you can start a new conversation with them like the first time you entered their mind, or we can skip that part and say you have the same conversation with them this time that you had last time.

1) Start a new conversation with Jace.
2) Repeat the conversation you had with Jace the last time.

>1
[Start a new conversation with Jace.]

You hunker down mentally as Jace's consciousness and yours intertwine.  You've trained enough that you can give Jace some mental privacy, but untrained, he immediately carreens painfully through your thoughts and memories following connections that happen to resonate, and you're pulled along. 

                                                                       *    *    *

You're racing to the park, Amaia in the throes of a prophecy but expertly navigating through traffic anyway; her hands in a death lock on the steering wheel of the Hyundai-- 

                                                                       *    *    *

The Hyundai looking so...normal, sitting in your high school's the parking lot as you and your parents approach the intense woman and old man standing next to it, here because...

1) oh no
2) Try to break the connection.

>undo
Quinlan Park Entrance
You step backwards on the strands.

* * *

>s
You transfer your consciousness to a new group of spiders...

Quinlan Park Entrance (in the spiders)
Two booths flank the entrance to the park to the north, where you can buy tickets and get information.  To the south is the parking lot.

You can see Jace manning the ticket booth, but the information booth is empty.

>enter jace
Gathering your thoughts together, you leave the spiders and transfer your consciousness into Jace.

Quinlan Park Entrance (in Jace) (in the ticket booth)
Two booths flank the entrance to the park to the north, where you can buy tickets and get information.  To the south is the parking lot.

In the area, you can sense the collective presence of dozens of spiders.

You hunker down mentally as Jace's consciousness and yours intertwine.  You've trained enough that you can give Jace some mental privacy, but untrained, he immediately carreens painfully through your thoughts and memories following connections that happen to resonate, and you're pulled along. 

                                                                       *    *    *

You're racing to the park, Amaia in the throes of a prophecy but expertly navigating through traffic anyway; her hands in a death lock on the steering wheel of the Hyundai-- 

                                                                       *    *    *

The Hyundai looking so...normal, sitting in your high school's the parking lot as you and your parents approach the intense woman and old man standing next to it, here because...

1) oh no
2) Try to break the connection.

>undo
Quinlan Park Entrance
You step backwards on the strands.

* * *

>l
Quinlan Park Entrance (in Jace) (in the ticket booth)
Two booths flank the entrance to the park to the north, where you can buy tickets and get information.  To the south is the parking lot.

In the area, you can sense the collective presence of dozens of spiders.

>reset
You feel the web of time time tighten beneath you, and with a rush, you slip backwards along it before it finally goes slack again, and you regain your hold.

You've gone to the beginning of the loop while in Jace's mind.  You can repeat the conversation you had with them the last time, or you can start a new conversation with them like the first time you entered their mind, or we can skip that part and say you have the same conversation with them this time that you had last time.

1) Start a new conversation with Jace.
2) Repeat the conversation you had with Jace the last time.

>3
There is no choice corresponding to that number.

>1
[Start a new conversation with Jace.]

You hunker down mentally as Jace's consciousness and yours intertwine.  You've trained enough that you can give Jace some mental privacy, but untrained, he immediately carreens painfully through your thoughts and memories following connections that happen to resonate, and you're pulled along. 

                                                                       *    *    *

You're racing to the park, Amaia in the throes of a prophecy but expertly navigating through traffic anyway; her hands in a death lock on the steering wheel of the Hyundai-- 

                                                                       *    *    *

The Hyundai looking so...normal, sitting in your high school's the parking lot as you and your parents approach the intense woman and old man standing next to it, here because...

1) oh no
2) Try to break the connection.

>1
[oh no]

                                                                       *    *    *

Homework finished, you're gazing across the room at Duncan, and his hair, and his shoulders, and the way he laughs, and your mind starts to wander, and then your mind starts to ACTUALLY WANDER and

1) "Jace, no!"
2) Try to break the connection.

>1
["Jace, no!"]

and you're suddenly READING EACH OTHERS MINDS and he KNOWS and Oh, geez, I'm so sorry I don't even HORRIFIED and SCARED and sees you across the room eyes glazed over Who even are you and how and yells

1) Try to explain.
2) Try to break the connection.

* * *

>n
You transfer your consciousness to a new group of spiders...

Top of Hill (in the spiders)
From the top of the hill, you can see the entire park below you: the reservoir to the north, the playground to the west, and all eight of the permanent sculptures in the park.

A collection of giant metal tubes and beams graces the top of the hill, known as "Coyote's Call".  It's an abstract design of joyful chaos, somehow incorporating even the curve of the hill into its own expression.

>w
You transfer your consciousness to a new group of spiders...

Playground (in the spiders)
You're at the top of the hill in the park.  This side has slides, swings, and a wide variety of brightly-colored climbing equipment.  The path curves from the south to the east side of the hill, along the ridge.

You also sense the presence of another mind nearby--maybe a kid?  You can't see them, though.

Dominating the sky to the east are the red metal tubes and bars of Coyote's Call.

Kids are playing, shrieking, and chasing each other up and around the platforms.

* * *

>w
You transfer your consciousness to a new group of spiders...

Playground (in the spiders)
You're at the top of the hill in the park.  This side has slides, swings, and a wide variety of brightly-colored climbing equipment.  The path curves from the south to the east side of the hill, along the ridge.

Dominating the sky to the east are the red metal tubes and bars of Coyote's Call.

Kids are playing, shrieking, and chasing each other up and around the platforms.

>z
Gently, you release your hold on time, letting it scroll forward.

You feel a slight tremor in the earth from somewhere nearby.

>l
Playground (in the spiders)
You're at the top of the hill in the park.  This side has slides, swings, and a wide variety of brightly-colored climbing equipment.  The path curves from the south to the east side of the hill, along the ridge.

Dominating the sky to the east are the red metal tubes and bars of Coyote's Call.

Kids are playing, shrieking, and chasing each other up and around the platforms.

>z
Gently, you release your hold on time, letting it scroll forward.

With a sudden roar, the entire east half of the hill collapses in on itself, taking the metal structure of Coyote's Call with it; its giant metal tubes and bars twisting apart from each other with terrifying screeches.  Trees, dirt, and grass fall into the gaping pit as the edges expand towards your side of the hill.

Playground (in the spiders)
You're at the top of the hill in the park.  This side has slides, swings, and a wide variety of brightly-colored climbing equipment.  The path curves from the south to the east side of the hill, along the ridge.

Coyote's Call has fallen into the gaping and still-expanding sinkhole.

The kids are reacting to the disaster in different ways.  Most seem to be running away, but some are transfixed by the sight, and at least one seems to have been caught taking a step towards the sinkhole.

This certainly seems to qualify as a disaster.  You take in your surroundings, determined to remember this moment.

>z
Gently, you release your hold on time, letting it scroll forward.

>r
I didn't understand that sentence.

>e
You transfer your consciousness to a new group of spiders...

Giant Pit (in the spiders)
The entire hill has collapsed in on itself, revealing a giant pit underneath. Bushes and trees are frozen mid-fall, as they pitch forward into the yawning chasm.

>d
You transfer your consciousness to a new group of spiders...

Sinkhole (in the spiders)
You're partway down a giant sinkhole that apparently has been growing under the park for some time.  Everything is caught in a state of falling:  dirt, grass, the red metal pieces of Coyote's Call, and the spiders themselves.

People are frozen in time, falling past you.

The majority of Coyote's Call is caught frozen near you as it tumbles.

>x call
Somehow, the artistic chaos from before has been dissipated into just... normal chaos.  It's now just a pile of falling red metal.

>x pieces
You can't see any such thing.

>x people
These people are going to die if you can't figure out a way to help them.

>x spiders
The minds of the spiders are refreshingly simple, unlike most people's minds.  As long as there are more spiders where you want to go, you can move in that direction when connected to them.

>z
As you release your hold on time, the last of the top of the hill falls past you into the deep.

From somewhere in the non-destroyed park, you hear an announcement being made.

The sun emerges again from behind the cloud.

* * *

>undo
Sinkhole
You step backwards on the strands.

>undo
Giant Pit
You step backwards on the strands.

>undo
Playground
You step backwards on the strands.

>undo
Playground
You step backwards on the strands.

>e
You transfer your consciousness to a new group of spiders...

Giant Pit (in the spiders)
The entire hill has collapsed in on itself, revealing a giant pit underneath. Bushes and trees are frozen mid-fall, as they pitch forward into the yawning chasm.

>x pit
You can't see any such thing.

>x bushes
The falling bushes and trees add to the general chaos of the collapsing hill and structure.

>x trees
The falling bushes and trees add to the general chaos of the collapsing hill and structure.

>d
You transfer your consciousness to a new group of spiders...

Sinkhole (in the spiders)
You're partway down a giant sinkhole that apparently has been growing under the park for some time.  Everything is caught in a state of falling:  dirt, grass, the red metal pieces of Coyote's Call, and the spiders themselves.

People are frozen in time, falling past you.

The majority of Coyote's Call is caught frozen near you as it tumbles.

>u
You transfer your consciousness to a new group of spiders...

Giant Pit (in the spiders)
The entire hill has collapsed in on itself, revealing a giant pit underneath. Bushes and trees are frozen mid-fall, as they pitch forward into the yawning chasm.

>d
You transfer your consciousness to a new group of spiders...

Sinkhole (in the spiders)
You're partway down a giant sinkhole that apparently has been growing under the park for some time.  Everything is caught in a state of falling:  dirt, grass, the red metal pieces of Coyote's Call, and the spiders themselves.

People are frozen in time, falling past you.

The majority of Coyote's Call is caught frozen near you as it tumbles.

* * *

>x call
Somehow, the artistic chaos from before has been dissipated into just... normal chaos.  It's now just a pile of falling red metal.

>z
As you release your hold on time, the last of the top of the hill falls past you into the deep.

From somewhere in the non-destroyed park, you hear an announcement being made.

The sun emerges again from behind the cloud.

* * *

>undo
Giant Pit
You step backwards on the strands.

>undo
Giant Pit
You step backwards on the strands.

>undo
You've gone as far backwards on this strand as you can manage.

* * *

>out
You can't exit one consciousness without going into another one.

>ne
You transfer your consciousness to a new group of spiders...

We went.

Plaza (in the spiders)
Paths run through this plaza from the south entrance, then splitting northwest around the hill, north up the hill, and east along it. 

To the northeast atop the hill is the iconic red metal structure of Coyote's Call.

Prominently displayed just inside the entrance is some sort of sculpture (LS TBD).

>n
You transfer your consciousness to a new group of spiders...

going something in a parky room for the first time.

Playground (in the spiders)
You're at the top of the hill in the park.  This side has slides, swings, and a wide variety of brightly-colored climbing equipment.  The path curves from the south to the east side of the hill, along the ridge.

Dominating the sky to the east are the red metal tubes and bars of Coyote's Call.

Kids are playing, shrieking, and chasing each other up and around the platforms.

Whatever Amaia is worried about is apparently happening in this park.  You'll need to wait to advance the loop and see what's going on.

We went.

Playground (in the spiders)
You're at the top of the hill in the park.  This side has slides, swings, and a wide variety of brightly-colored climbing equipment.  The path curves from the south to the east side of the hill, along the ridge.

Dominating the sky to the east are the red metal tubes and bars of Coyote's Call.

Kids are playing, shrieking, and chasing each other up and around the platforms.

* * *

>x me
You're pragmatically dressed in jeans, a "Hu" T-shirt, and sneakers.  Your curls are somehow behaving today, probably because you didn't try to do anything with them this morning.