BUG: Meet_Zora has no intro-page.
BUG: Meet_Zora has no mind-touch.

Amaia screeches into the parking lot, and expertly zips into an open spot.  She closes her eyes briefly, checking, then opens them again, only fractionally less concerned.  "OK," she says, breathlessly, "whatever it is that's going to happen hasn't happened yet.  Zora," she turns to you apologetically over her shoulder, "you won't have a lot of time, but the future's still branching, so it should be enough.  Lestar, you're up." 

From the passenger seat, Lestar grins at both of you, his white eyebrows quirking soothingly, and he reaches behind his seat to pat you reassuringly on the arm.  "You got this, kid," he says "You've been doing great; this'll be just like the other times."  From Amaia's panicked expression, you can tell she disagrees, but she says nothing.  You take a deep breath and grab Lestar's hand, dry and warm, and it grounds you.

Amaia takes Lestar's other hand, then grabs yours, the contact sleek with sweat from both of you.  Lestar nods at you both, and closes his eyes.

Everything freezes.

You have all the time in the world.

Fate's Gallery
An Interactive Story by Lucian Smith
Release 0 / Serial number 240623 / Inform 7 v10.1.2 / D

Quinlan Park Parking Lot (in the Hyundai)
Scattered cars fill the parking lot, including the Hyundai you came here in. The parking lot is just off of 48th street to the west.   To the north is the entrance to the park.

Looming over the parking lot to the east is a huge sculpture  whose details have yet to be decided (LS TBD).

Amaia is turned sideways in the driver's seat, grasping your hand and Lestar's.  Even frozen, she radiates intensity and movement.

Lestar's eyes are shut in calm concentration.  His relaxed hands hold yours and Amaia's, completing the triangle.

In the area, you can sense the collective presence of dozens of spiders.

>x amaia
Amaia is a tall dark-haired woman with piercing but tired brown eyes.

>x lestar
Lestar is an old man with giant bushy white eyebrows that make it impossible for him to hide his emotions.

>x me
You're pragmatically dressed in jeans, a "Hu" T-shirt, and sneakers.  Your curls are somehow behaving today, probably because you didn't try to do anything with them this morning.

>i
You are carrying nothing.

>x lester
(It's "Lestar", not "Lester".)

>w
That direction seems to be outside Lestar's area of influence.  Hopefully that means you won't need to go that way.

>out
While frozen, you can enter the minds around you, and you're aware of your surroundings, but can't do anything physical.

>enter lestar
Entering Lestar's mind will be the main hint system of the game, I think, but I haven't tried to do anything with it yet.

>touch lestar
Reaching out with your mind, you brush Lestar's surface thoughts with your own.  Instantly, you feel the thought, "Hi, Zora!  Just figure out what's going on, then get people to safety.  You can do this."  It must have been waiting for you, which in retrospect you feel you should have anticipated.  He's an old Vested, after all, and has been doing this for years.

>enter amaia
You can't imagine actually entering Amaia's consciousness and giving her full access to your mind.  You'd never be able to look her in the eye again, and you have to work with her.

>touch amaia
Amaia still intimidates you, and you're pretty sure her surface thoughts would just be "Zora!  Do your job already!"

>enter me
You're already in yourself, for what that's worth.

>touch spiders
The surface thoughts of the spiders are entirely instinctual, and refreshing in their simplicity.  You feel your own emotions being acknowledged in return, without them affecting the spiders in the slightest.

>enter spiders
With practiced ease, you move your consciousness out of your own head, and into the surrounding spiders.  Your perception shifts, and you see the parking lot as if you were standing in it, though patched together from dozens of small views.

Quinlan Park Parking Lot (in the spiders)
Scattered cars fill the parking lot, including the Hyundai you came here in. The parking lot is just off of 48th street to the west.   To the north is the entrance to the park.

Looming over the parking lot to the east is a huge sculpture  whose details have yet to be decided (LS TBD).

>x sculpture
It's a sculpture looming over the east fence (LS TBD).

>n
You transfer your consciousness to a new group of spiders...

Quinlan Park Entrance (in the spiders)
Two booths flank the entrance to the park to the north, where you can buy tickets and get information.  To the south is the parking lot.

You can see a young man manning the ticket booth, but the information booth is empty.

>x booths
Which do you mean, the information booth or the ticket booth?

>information
The information booth is unmanned, but there's a stack of fliers resting on the sill.

>x flyers
You can't see any such thing.

>x young man
A young man with a friendly but bored expression, a Quinlan Park employee vest, and a name tag reading "Jace".

>l
Quinlan Park Entrance (in the spiders)
Two booths flank the entrance to the park to the north, where you can buy tickets and get information.  To the south is the parking lot.

You can see Jace manning the ticket booth, but the information booth is empty.

>x ticket
The ticket booth has a sign with a pay-what-you-want pricing scheme ranging from "I just need more grass and art in my life - FREE" through "I think you guys are amazing and would love to be listed as a patron - $1000".  Jace is manning the booth, taking donations from the park-goers.

>x jace
A young man with a friendly but bored expression, a Quinlan Park employee vest, and a name tag reading "Jace".

>enter jace
You'll have to enter his mind at some point, but you don't know why yet, or how he could help.  Until you do, you need to do more reconnaisance.

>touch jace
You'll have to enter his mind at some point, but you don't know why yet, or how he could help.  Until you do, you need to do more reconnaisance.

>enter ticket
You transfer your consciousness into the spiders inside the ticket booth.

Quinlan Park Entrance (in the spiders) (in the ticket booth)
Two booths flank the entrance to the park to the north, where you can buy tickets and get information.  To the south is the parking lot.

In the ticket booth you can see Jace.

>enter ticket booth
You're already in the ticket booth.

>enter information booth
You transfer your consciousness into the spiders inside the information booth.

Quinlan Park Entrance (in the spiders) (in the information booth)
Two booths flank the entrance to the park to the north, where you can buy tickets and get information.  To the south is the parking lot.

You can see Jace manning the ticket booth, but the information booth is empty.

>out
You transfer your consciousness into the spiders outside the information booth.

Quinlan Park Entrance (in the spiders)
Two booths flank the entrance to the park to the north, where you can buy tickets and get information.  To the south is the parking lot.

You can see Jace manning the ticket booth, but the information booth is empty.

>out
You can't exit one consciousness without going into another one.

>n
You transfer your consciousness to a new group of spiders...

Plaza (in the spiders)
Paths run through this plaza from the south entrance, then splitting northwest around the hill, north up the hill, and east along it. 

To the northeast atop the hill is the iconic red metal structure of Coyote's Call.

Prominently displayed just inside the entrance is some sort of sculpture (LS TBD).

>nw
You transfer your consciousness to a new group of spiders...

Path By Hill (in the spiders)
The path runs southeast to northwest here along the edge of the park, and splits off to the east as well, heading up the hill above you.  A fence mostly hidden by shrubbery to your west hides 48th street, and blocks most of the sound from the passing cars.

Though the hill is in the way, you can still see the tops of the red metal structure of Coyote's Call past the rise to the east.

Whatever Amaia is worried about is apparently happening in this park.  You'll need to wait to advance the loop and see what's going on.

>x call
Coyote's Call is the iconic sculpture of Quinlan Park.  Made of large red metal tubes and beams, it dominates the landscape from atop the central hill to the east.

>z
Gently, you release your hold on time, letting it scroll forward.

>nw
You transfer your consciousness to a new group of spiders...

Under Bridge (in the spiders)
A simple and delicate sculpture entitled "Fire and Forge" sits here, nestled under the 48th Street Bridge on the banks of Brushstroke Reservoir to the north.  The path leads back southeast to the main park area.

>x fire
A plaque in the ground identifies this sculpture as "Fire and Forge".  Long spines of twisting reddish metal emerge from the ground, reminiscent of flames.

>x plaque
Fire and Forge.  Metal and stain, 2007, Amelia Thomas.

The red metal spires most obviously evokes flames, but also passion, leading the majority of scholars to believe this to be representative of the relationship of Aphrodite and Hephaestus.

>x spires
As you examine the twisted metal from different angles, you can almost imagine you see both swords and erotic imagery.  This would be consistent with the church of Aphrodite's reclamation of her dominion over both sex and war in its series of reforms in the 70's and 80's.  A small stamped icon of a cluster of dates would seem to indicate that the sculptor was part of the Inannan denomination.

>x dates
(as in the fruit.)

>x innana
As you examine the twisted metal from different angles, you can almost imagine you see both swords and erotic imagery.  This would be consistent with the church of Aphrodite's reclamation of her dominion over both sex and war in its series of reforms in the 70's and 80's.  A small stamped icon of a cluster of dates would seem to indicate that the sculptor was part of the Inannan denomination.

>x innanan
As you examine the twisted metal from different angles, you can almost imagine you see both swords and erotic imagery.  This would be consistent with the church of Aphrodite's reclamation of her dominion over both sex and war in its series of reforms in the 70's and 80's.  A small stamped icon of a cluster of dates would seem to indicate that the sculptor was part of the Inannan denomination.

>e
You transfer your consciousness to a new group of spiders...

Beach Sculpture (in the spiders)
An east-west path runs along the Brushstroke Reservoir beach. A large complicated structure sits here, fodder for some sort of puzzle (LS TBD).  To your south, you can see the playground on top of the hill.

To the southeast atop the hill is the iconic red metal structure of Coyote's Call.

>x structure
Coyote's Call is the iconic sculpture of Quinlan Park.  Made of large red metal tubes and beams, it dominates the landscape from atop the central hill to the southeast.

>x tubes
Coyote's Call is the iconic sculpture of Quinlan Park.  Made of large red metal tubes and beams, it dominates the landscape from atop the central hill to the southeast.

>e
You transfer your consciousness to a new group of spiders...

Water Sculpture (in the spiders)
Here at the northeast section of the park is a fountain-sculpture-thing in the shallow water of the reservoir.  Paths run from here south along the edge of the hill, southwest up the hill, and west along the beach.

To the southwest atop the hill is the iconic red metal structure of Coyote's Call.

>s
You transfer your consciousness to a new group of spiders...

East Hill (in the spiders)
A north-south path rises here on the lower east end of the hill.  A sculpture labeled "Bird and Cage" is displayed here; a mass of metal bits on poles.

Up the hill to the west is the iconic red metal structure of Coyote's Call.

>x bird
A set of twisted pieces of metal and stone, each sitting atop a metal pole (more LS TBD).

>x pole
A set of twisted pieces of metal and stone, each sitting atop a metal pole (more LS TBD).

>s
You transfer your consciousness to a new group of spiders...

Bewildering Bridges (in the spiders)
Three paths from the west, northwest, and north converge here at a bewildering complex of bridges, walkways, and staircases, some fixed, and some turning gently in the wind.

A ways northwest up the hill you can see the iconic red metal structure of Coyote's Call.

>x call
Coyote's Call is the iconic sculpture of Quinlan Park.  Made of large red metal tubes and beams, it dominates the landscape from atop the central hill to the northwest.

>x tubes
Coyote's Call is the iconic sculpture of Quinlan Park.  Made of large red metal tubes and beams, it dominates the landscape from atop the central hill to the northwest.

>w
You transfer your consciousness to a new group of spiders...

Sculpture By Lot (in the spiders)
The path curves from the west to the southeast here, winding through a giant sculpture that looms over the fence by the parking lot.  The main hill of the park is to the north.

Up the hill to the north are the red metal tubes and bars of Coyote's Call.

>w
You spot a spider on the west wall, and through it, move your consciousness to the spiders on the other side.

Quinlan Park Parking Lot (in the spiders)
Scattered cars fill the parking lot, including the Hyundai you came here in. The parking lot is just off of 48th street to the west.   To the north is the entrance to the park.

Looming over the parking lot to the east is a huge sculpture  whose details have yet to be decided (LS TBD).

>e
You spot a spider on the east wall, and through it, move your consciousness to the spiders on the other side.

Sculpture By Lot (in the spiders)
The path curves from the west to the southeast here, winding through a giant sculpture that looms over the fence by the parking lot.  The main hill of the park is to the north.

Up the hill to the north are the red metal tubes and bars of Coyote's Call.

>n
You transfer your consciousness to a new group of spiders...

Top of Hill (in the spiders)
From the top of the hill, you can see the entire park below you: the reservoir to the north, the playground to the west, and all eight of the permanent sculptures in the park.

A collection of giant metal tubes and beams graces the top of the hill, known as "Coyote's Call".  It's an abstract design of joyful chaos, somehow incorporating even the curve of the hill into its own expression.

>w
You transfer your consciousness to a new group of spiders...

Playground (in the spiders)
You're at the top of the hill in the park.  This side has slides, swings, and a wide variety of brightly-colored climbing equipment.  The path curves from the south to the east side of the hill, along the ridge.

Dominating the sky to the east are the red metal tubes and bars of Coyote's Call.

Kids are playing, shrieking, and chasing each other up and around the platforms.

>x kids
The kids are all having a great time swinging and climbing or chasing each other around.  Some of them seem to be playing some version of "hide and seek".

>e
You transfer your consciousness to a new group of spiders...

Top of Hill (in the spiders)
From the top of the hill, you can see the entire park below you: the reservoir to the north, the playground to the west, and all eight of the permanent sculptures in the park.

A collection of giant metal tubes and beams graces the top of the hill, known as "Coyote's Call".  It's an abstract design of joyful chaos, somehow incorporating even the curve of the hill into its own expression.

>x coyote
Art is a conversation between the artist, the subject, and the viewer, but as you take in the tubes and spires of this particular piece, you can't help but wonder what the current Vested of Coyote would make of it.  They've not gone public, so they could be anyone.  Could they be like you, newly awakened to their abilities, trying and failing (or succeeding?) to find answers in the church dedicated to the idea they represent?  Like Lestar, so self-assured and confident, understanding and perfectly molded to their place in the world?  Like Amaia, driven to prove themselves, to surpass their forebearers?  How would that color their response to this giant red mass of sculpted metal?

>z
Gently, you release your hold on time, letting it scroll forward.

You feel an ominous rumbling from deep under the earth.

>z
Gently, you release your hold on time, letting it scroll forward.

With a roar, the entire top of the hill collapses in on itself, and your perception shatters as spiders are shaken off webs and perches, spinning out emergency strands to catch the wind and slow their falls.  Straining, you manage to reassert your hold on time, freezing everything in place again.  Gradually, you stitch together a new coherent view of your surroundings.

Giant Pit (in the spiders)
The entire hill has collapsed in on itself, revealing a giant pit underneath. Bushes and trees are frozen mid-fall, as they pitch forward into the yawning chasm.

People are caught frozen in time but doomed:  a stumbling woman falling forward into the hole; a man clinging desperately to a cylinder of Coyote's Call as he and the cylinder plunge into the abyss.

Coyote's Call is collapsing into the sinkhole along with everything else.  Frozen in time, the new configuration of its tubes and beams makes it seem even more joyfully chaotic.  You are probably the only person who will ever experience it this way, and it makes the combination of destruction and art intensely personal.

This certainly seems to qualify as a disaster.  You take in your surroundings, determined to remember this moment.

>x coyote
The entire hill gave way all at once, and Coyote's Call is now falling, its original configuration lost.  But you can't help thinking that it was at the epicenter of the collapse.

>x people
These people are going to die if you can't figure out a way to help them.

>x woman
These people are going to die if you can't figure out a way to help them.

>x man
These people are going to die if you can't figure out a way to help them.

>d
You transfer your consciousness to a new group of spiders...

Sinkhole (in the spiders)
You're partway down a giant sinkhole that apparently has been growing under the park for some time.  Everything is caught in a state of falling:  dirt, grass, the red metal pieces of Coyote's Call, and the spiders themselves.

A spear of red metal from Coyote's Call falls through open space here.

>x metal
Etched into the base of the spear is a design that must have been buried in the dirt:  two crossed lines circumscribed by a rounded triangle.

>x people
You can't see any such thing.

>d
From here, you can sense spiders above and below you, but the ones below are outside of Lestar's sphere of influence.

>z
You anchor your consciousness in spiders on the walls of the cavern, and release your hold on time once more.  It's almost not enough:  the mass of dirt and detritus that pours down from above scrapes more than a few spiders from the walls, and it takes all your mental agility to maintain coherence as you flit between the slightly more anchored spider minds, before pulling time to a stop once again.

Sinkhole (in the spiders)
You're partway down a giant sinkhole that apparently has been growing under the park for some time.  Everything is caught in a state of falling:  dirt, grass, the red metal pieces of Coyote's Call, and the spiders themselves.

People are frozen in time, falling past you.

A spear of red metal from Coyote's Call falls through open space here.

>x people
These people are going to die if you can't figure out a way to help them.

>x coyote
Somehow, the artistic chaos from before has been dissipated into just... normal chaos.  It's now just a pile of falling red metal.

>z
As you release your hold on time, the last of the top of the hill falls past you into the deep.

From somewhere in the non-destroyed park, you hear an announcement being made.

The sun emerges again from behind the cloud.

>undo
Sinkhole
You step backwards on the strands.

>x people
These people are going to die if you can't figure out a way to help them.

>touch people
You brace yourself as the panic from each person washes over you, and think back at them <This isn't the end; I'll figure out a way to help; I'm so sorry.>  If you do succeed, these people will never be in this position, but it feels right to do it anyway.  You think Lestar might understand.

>enter people
There's nothing these people can do to save themselves at this point in the loop; you'll have to help earlier in the cycle.

>z
As you release your hold on time, the last of the top of the hill falls past you into the deep.

From somewhere in the non-destroyed park, you hear an announcement being made.

The sun emerges again from behind the cloud.

>u
You transfer your consciousness to a new group of spiders...

Giant Pit (in the spiders)
The entire hill has collapsed in on itself, revealing a giant pit underneath. Bushes and trees are frozen mid-fall, as they pitch forward into the yawning chasm.

>e
You transfer your consciousness to a new group of spiders...

East Hill (in the spiders)
A north-south path rises here on the lower east end of the hill.  A sculpture labeled "Bird and Cage" is displayed here; a mass of metal bits on poles.

Much of the hill to the west is missing, including Coyote's call.

>z
Gently, you release your hold on time, letting it scroll forward.

LS TBD:  the sinkhole expands.

>z
Gently, you release your hold on time, letting it scroll forward.

>undo
East Hill
You step backwards on the strands.

>undo
East Hill
You step backwards on the strands.

>undo
Giant Pit
You step backwards on the strands.

>undo
Sinkhole
You step backwards on the strands.

>undo
Sinkhole
You step backwards on the strands.

>u
You transfer your consciousness to a new group of spiders...

Giant Pit (in the spiders)
The entire hill has collapsed in on itself, revealing a giant pit underneath. Bushes and trees are frozen mid-fall, as they pitch forward into the yawning chasm.

* * *

>e
You transfer your consciousness to a new group of spiders...

East Hill (in the spiders)
A north-south path rises here on the lower east end of the hill.  A sculpture labeled "Bird and Cage" is displayed here; a mass of metal bits on poles.

Much of the hill to the west is missing, including Coyote's call.

>z
Gently, you release your hold on time, letting it scroll forward.

With a squawk, hidden speakers come to life, and you hear Jace say, "Um, hi, I guess the park is... closed?  Everyone should get out, at least.  If you can!  If you can't, um, sorry, I'll see if I can get help.  I'll do that next.  But, like, right now, everyone else should leave."

The sun emerges again from behind the cloud.

>sw
You transfer your consciousness to a new group of spiders...

Bewildering Bridges (in the spiders)
Three paths from the west, northwest, and north converge here at a bewildering complex of bridges, walkways, and staircases, some fixed, and some turning gently in the wind.

Coyote's Call has disappeared from view; it used to be visible to the northwest.

>w
You transfer your consciousness to a new group of spiders...

Sculpture By Lot (in the spiders)
The path curves from the west to the southeast here, winding through a giant sculpture that looms over the fence by the parking lot.  The main hill of the park is to the north.

Bits of the Coyote's Call structure can still be seen as it falls into the sinkhole.

>nw
You transfer your consciousness to a new group of spiders...

Plaza (in the spiders)
Paths run through this plaza from the south entrance, then splitting northwest around the hill, north up the hill, and east along it. 

To the northeast, the iconic red metal of Coyote's Call is no longer visible.

Prominently displayed just inside the entrance is some sort of sculpture (LS TBD).

>s
You transfer your consciousness to a new group of spiders...

Quinlan Park Entrance (in the spiders)
Two booths flank the entrance to the park to the north, where you can buy tickets and get information.  To the south is the parking lot.

You can see Jace manning the ticket booth, but the information booth is empty.

>z
Gently, you release your hold on time, letting it scroll forward.

LS TBD:  the sinkhole expands.

* * *

>z
Gently, you release your hold on time, letting it scroll forward.

>z
Gently, you release your hold on time, letting it scroll forward.

Jace pulls a hand-held microphone off the wall of the ticket booth.

With a squawk, hidden speakers come to life, and you hear Jace say, "Oh shit everyone get out!  911's on their way but that hole's getting larger!  Parking lot, everyone!"

>z
Gently, you release your hold on time, letting it scroll forward.

Jace gets out of the ticket booth.

>z
Gently, you release your hold on time, letting it scroll forward.

Jace goes south.

>z
Gently, you release your hold on time, letting it scroll forward.

>z
Gently, you release your hold on time, letting it scroll forward.

You feel the web of time time tighten beneath you, and with a rush, you slip backwards along it.  Images blur past you before the web finally goes slack again, and you regain your hold.

Quinlan Park Entrance (in the spiders)
Two booths flank the entrance to the park to the north, where you can buy tickets and get information.  To the south is the parking lot.

You can see Jace manning the ticket booth, but the information booth is empty.

>enter jace
Gathering your thoughts together, you leave the spiders and transfer your consciousness into Jace.

Quinlan Park Entrance (in Jace) (in the ticket booth)
Two booths flank the entrance to the park to the north, where you can buy tickets and get information.  To the south is the parking lot.

In the area, you can sense the collective presence of dozens of spiders.

You hunker down mentally as Jace's consciousness and yours intertwine.  You've trained enough that you can give Jace some mental privacy, but untrained, he immediately carreens painfully through your thoughts and memories following connections that happen to resonate, and you're pulled along. 

                                                                *    *    *

You're racing to the park, Amaia in the throes of a prophecy but expertly navigating through traffic anyway; her hands in a death lock on the steering wheel of the Hyundai-- 

                                                                *    *    *

The Hyundai looking so...normal, sitting in your high school's the parking lot as you and your parents approach the intense woman and old man standing next to it, here because...

1) oh no
2) Try to break the connection.

>1
[oh no]

                                                                *    *    *

Homework finished, you're gazing across the room at Duncan, and his hair, and his shoulders, and the way he laughs, and your mind starts to wander, and then your mind starts to ACTUALLY WANDER and

1) "Jace, no!"
2) Try to break the connection.

>undo
Quinlan Park Entrance
You step backwards on the strands.

>2
[Try to break the connection.]

You continue to be swept along in your memory.
                                                                *    *    *

Homework finished, you're gazing across the room at Duncan, and his hair, and his shoulders, and the way he laughs, and your mind starts to wander, and then your mind starts to ACTUALLY WANDER and

1) "Jace, no!"
2) Try to break the connection.

>1
["Jace, no!"]

and you're suddenly READING EACH OTHERS MINDS and he KNOWS and Oh, geez, I'm so sorry I don't even HORRIFIED and SCARED and sees you across the room eyes glazed over Who even are you and how and yells

1) Try to explain.
2) Try to break the connection.

>undo
Quinlan Park Entrance
You step backwards on the strands.

>2
[Try to break the connection.]

You continue to be swept along in your memory.
and you're suddenly READING EACH OTHERS MINDS and he KNOWS and Oh, geez, I'm so sorry I don't even HORRIFIED and SCARED and sees you across the room eyes glazed over Who even are you and how and yells

1) Try to explain.
2) Try to break the connection.

>1
[Try to explain.]

I'm a Vested, and our minds-- you start to explain, but the memory continues to sweep forward...

yells "Zora!" and you--Holy crap, you're a Vested?!  That is so cool!

Blessedly, the memory starts to fade, replaced by Jace's excitement.

Oh, man, "Concrete Sinners" has Vested in it, and the writers handle it so well, it's like they always pick the best mythos to draw from.  I've always wondered what it was like to be a Vested; I read President Calder's memoir like eight times and watched the "Forged in Flames" documentary about him twice, but they both seemed a little glossed-over, like they were both just painting him as kind of a generic hero.  And the ancient myths are more the stories people told about Vestedness, instead of the actual Vested, if that makes any sense.  Is this... He looks around, but the memory is gone.  ...your origin story?

1) "Kind of, I guess.  It's, uh, not been easy."
2) "Jace, I need your help."

I beg your pardon?

>1
["Kind of, I guess.  It's, uh, not been easy."]

Wow, yeah, but still!  Powers of the ancients, passed on to the next-born for thousands of years!  Who did you get?  You're not Wisdom, are you?  Angiras, Kratu, Athena?  We go to their church!  A Kratu denomination; my dad says they have fewer extremists.

You sigh, and answer his question.  I'm "the Past", basically.  Clotho, Urðr, Laima; those guys.  It sort of fits; memories are kind of my thing.  But I can't decide anyone's fate; that's something my stupid church made up.  You feel Jace startle at the idea of a Vested not liking their own church, and feel bad for shaking his worldview.  A little.

Wow, OK!  I guess I never thought about.... that.  You feel a small blast of awkwardness from his mind, but he presses on.  So, the Past!  And memories!  Do you need one of my old memories or something?

1) Show him the memory of the sinkhole.

>undo
Quinlan Park Entrance
You step backwards on the strands.

>2
["Jace, I need your help."]

Right!  OK, yes.  You're probably here for a reason.  Talking to me!  In my head!  This is so--sorry! I mean, right.  Look, I can be calm!  I mean, not look, I guess.  Think?  Feel?  Was I being rude to say look?  I've never interacted with a Vested before; I didn't even know there was one in the state!  And now there's one in my head!  Eeee!

1) Show him the memory of the sinkhole.

>undo
Quinlan Park Entrance
You step backwards on the strands.

>undo
Quinlan Park Entrance
You step backwards on the strands.

>l
You continue to be swept along in your memory.
and you're suddenly READING EACH OTHERS MINDS and he KNOWS and Oh, geez, I'm so sorry I don't even HORRIFIED and SCARED and sees you across the room eyes glazed over Who even are you and how and yells

1) Try to explain.
2) Try to break the connection.

>2
[Try to break the connection.]

You continue to be swept along in your memory.

yells "Zora!" and you finally snap back to yourself again, and everyone's looking at Duncan and Duncan is looking at you and your eyes plead but he smirks Oh, geez, I'm so sorry, I don't need to see this, I should be--

                                                                *    *    *

You're in a meadow by a lake, your consciousness distributed in hundreds of spiders, letting time slip by, and totally at peace.  A breeze plays across the meadow and you feel it in each web in turn.

1) Appreciate the meadow for a bit.
2) "Jace, I need your help."

>1
[Appreciate the meadow for a bit.]

Jace quietly waits in the memory of the meadow with you.  His excitement and wonder leak everywhere, making the memory not quite as calming as it usually is.  It's still a nice break from reliving the most embarassing moment of your entitre life, so there's that.

Finally, you speak.  Thanks for finding this place.  There aren't many who find their way here, so it's nice.

I... assume there aren't many who find their way to "the most embarassing moment of your life", either, so sorry about that, Jace responds.  Which means he's one of the people who also hears your inner monologue.  Yeah, he confirms.   Well, OK, then.

You both appreciate the meadow for a bit more.  So, you're a Vested?  Jace asks.  Power of the ancients, passed on to the next-born for thousands of years?  Feeling confirmation from you, he can't contain his delight.  That's so cool!  And you can go into people's heads!  And into spider's heads!  I can't even imagine how you manage to stitch together a coherent perspective from all of them at once.  I've read stories, of course, but none of them even hinted at abilities like this!

1) "It's not actually that glamourous."
2) "Jace, I need your help."

>1
["It's not actually that glamourous."]

Well, sure, Jace replies, but you can still do stuff nobody else can!  Not even other Vested!  You can't help but think about the weight of the burden that having this job has been, and Jace winces.  Sorry, yeah, the extra responsibility must be hard.  But, you know, if you weren't there, more people would be hurt?  Because of you, people have better lives, right?

He's... trying to cheer you up.  You were worried about being judged, and you're being cheered.  It didn't really work, but it's sweet.  Look, I know there's something you need my help for; you've avoided asking twice now.  What do you need?  I'm happy to help.

1) Show him the memory of the sinkhole.

>1
[Show him the memory of the sinkhole.]

You show Jace the snapshot in your mind of the sinkhole.  Oh, man, is that what's about to happen?  I better evacuate the park!

Jace pulls a hand-held microphone off the wall of the ticket booth.

With a squawk, hidden speakers come to life, and you hear Jace say, "Hi, everyone!  Um, the park is now closed.  Everyone needs to leave the park immediately.  The, uh, Army Corps of Engineers reported that, uh, crap, I can't... look.  There's a Vested emergency, okay?  Everyone is in danger; you need to leave right now."

Quinlan Park Entrance (in Jace) (in the ticket booth)
Two booths flank the entrance to the park to the north, where you can buy tickets and get information.  To the south is the parking lot.

In the area, you can sense the collective presence of dozens of spiders.

>z
Time passes.

>z
Time passes.

>reset
You feel the web of time time tighten beneath you, and with a rush, you slip backwards along it.  Images blur past you before the web finally goes slack again, and you regain your hold.

You've gone to the beginning of the loop while in Jace's mind.  You can start a new conversation with them like the first time you entered their mind, or we can skip that part and say you have the same conversation with them this time that you had last time.

1) Start a new conversation with Jace.
2) Repeat the conversation you had with Jace the last time.

>1
[Start a new conversation with Jace.]

You hunker down mentally as Jace's consciousness and yours intertwine.  You've trained enough that you can give Jace some mental privacy, but untrained, he immediately carreens painfully through your thoughts and memories following connections that happen to resonate, and you're pulled along. 

                                                                *    *    *

You're racing to the park, Amaia in the throes of a prophecy but expertly navigating through traffic anyway; her hands in a death lock on the steering wheel of the Hyundai-- 

                                                                *    *    *

The Hyundai looking so...normal, sitting in your high school's the parking lot as you and your parents approach the intense woman and old man standing next to it, here because...

1) oh no
2) Try to break the connection.

>undo
Quinlan Park Entrance
You step backwards on the strands.

>2
[Repeat the conversation you had with Jace the last time.]

You go through the same conversation with Jace that you had last time (though it's the first time for them).
You show Jace the snapshot in your mind of the sinkhole.  Oh, man, is that what's about to happen?  I better evacuate the park!

Jace pulls a hand-held microphone off the wall of the ticket booth.

With a squawk, hidden speakers come to life, and you hear Jace say, "Hi, everyone!  Um, the park is now closed.  Everyone needs to leave the park immediately.  The, uh, Army Corps of Engineers reported that, uh, crap, I can't... look.  There's a Vested emergency, okay?  Everyone is in danger; you need to leave right now."

Quinlan Park Entrance (in Jace) (in the ticket booth)
Two booths flank the entrance to the park to the north, where you can buy tickets and get information.  To the south is the parking lot.

In the area, you can sense the collective presence of dozens of spiders.

>undo
Quinlan Park Entrance
You step backwards on the strands.

>l
Quinlan Park Entrance (in Jace) (in the ticket booth)
Two booths flank the entrance to the park to the north, where you can buy tickets and get information.  To the south is the parking lot.

In the area, you can sense the collective presence of dozens of spiders.

>enter spiders
Gathering your thoughts together, you leave Jace and transfer your consciousness into the spiders.

Quinlan Park Entrance (in the spiders)
Two booths flank the entrance to the park to the north, where you can buy tickets and get information.  To the south is the parking lot.

You can see Jace manning the ticket booth, but the information booth is empty.

>n
You transfer your consciousness to a new group of spiders...

Plaza (in the spiders)
Paths run through this plaza from the south entrance, then splitting northwest around the hill, north up the hill, and east along it. 

To the northeast atop the hill is the iconic red metal structure of Coyote's Call.

Prominently displayed just inside the entrance is some sort of sculpture (LS TBD).

>enter jace
You can't see any such thing.

>s
You transfer your consciousness to a new group of spiders...

Quinlan Park Entrance (in the spiders)
Two booths flank the entrance to the park to the north, where you can buy tickets and get information.  To the south is the parking lot.

You can see Jace manning the ticket booth, but the information booth is empty.

>enter jace
Gathering your thoughts together, you leave the spiders and transfer your consciousness into Jace.

Quinlan Park Entrance (in Jace) (in the ticket booth)
Two booths flank the entrance to the park to the north, where you can buy tickets and get information.  To the south is the parking lot.

In the area, you can sense the collective presence of dozens of spiders.

You hunker down mentally as Jace's consciousness and yours intertwine.  You've trained enough that you can give Jace some mental privacy, but untrained, he immediately carreens painfully through your thoughts and memories following connections that happen to resonate, and you're pulled along. 

                                                                *    *    *

You're racing to the park, Amaia in the throes of a prophecy but expertly navigating through traffic anyway; her hands in a death lock on the steering wheel of the Hyundai-- 

                                                                *    *    *

The Hyundai looking so...normal, sitting in your high school's the parking lot as you and your parents approach the intense woman and old man standing next to it, here because...

1) oh no
2) Try to break the connection.

>undo
Quinlan Park Entrance
You step backwards on the strands.

>undo
Plaza
You step backwards on the strands.

>undo
Plaza
You step backwards on the strands.

>undo
Quinlan Park Entrance
You step backwards on the strands.

* * *

>l
Quinlan Park Entrance (in Jace) (in the ticket booth)
Two booths flank the entrance to the park to the north, where you can buy tickets and get information.  To the south is the parking lot.

In the area, you can sense the collective presence of dozens of spiders.

>reset
You feel the web of time time tighten beneath you, and with a rush, you slip backwards along it.  Images blur past you before the web finally goes slack again, and you regain your hold.

You've gone to the beginning of the loop while in Jace's mind.  You can start a new conversation with them like the first time you entered their mind, or we can skip that part and say you have the same conversation with them this time that you had last time.

1) Start a new conversation with Jace.
2) Repeat the conversation you had with Jace the last time.

>3
There is no choice corresponding to that number.

>1
[Start a new conversation with Jace.]

You hunker down mentally as Jace's consciousness and yours intertwine.  You've trained enough that you can give Jace some mental privacy, but untrained, he immediately carreens painfully through your thoughts and memories following connections that happen to resonate, and you're pulled along. 

                                                                *    *    *

You're racing to the park, Amaia in the throes of a prophecy but expertly navigating through traffic anyway; her hands in a death lock on the steering wheel of the Hyundai-- 

                                                                *    *    *

The Hyundai looking so...normal, sitting in your high school's the parking lot as you and your parents approach the intense woman and old man standing next to it, here because...

1) oh no
2) Try to break the connection.

>1
[oh no]

                                                                *    *    *

Homework finished, you're gazing across the room at Duncan, and his hair, and his shoulders, and the way he laughs, and your mind starts to wander, and then your mind starts to ACTUALLY WANDER and

1) "Jace, no!"
2) Try to break the connection.

>1
["Jace, no!"]

and you're suddenly READING EACH OTHERS MINDS and he KNOWS and Oh, geez, I'm so sorry I don't even HORRIFIED and SCARED and sees you across the room eyes glazed over Who even are you and how and yells

1) Try to explain.
2) Try to break the connection.

>1
[Try to explain.]

I'm a Vested, and our minds-- you start to explain, but the memory continues to sweep forward...

yells "Zora!" and you--Holy crap, you're a Vested?!  That is so cool!

Blessedly, the memory starts to fade, replaced by Jace's excitement.

Oh, man, "Concrete Sinners" has Vested in it, and the writers handle it so well, it's like they always pick the best mythos to draw from.  I've always wondered what it was like to be a Vested; I read President Calder's memoir like eight times and watched the "Forged in Flames" documentary about him twice, but they both seemed a little glossed-over, like they were both just painting him as kind of a generic hero.  And the ancient myths are more the stories people told about Vestedness, instead of the actual Vested, if that makes any sense.  Is this... He looks around, but the memory is gone.  ...your origin story?

1) "Kind of, I guess.  It's, uh, not been easy."
2) "Jace, I need your help."

>1
["Kind of, I guess.  It's, uh, not been easy."]

Wow, yeah, but still!  Powers of the ancients, passed on to the next-born for thousands of years!  Who did you get?  You're not Wisdom, are you?  Angiras, Kratu, Athena?  We go to their church!  A Kratu denomination; my dad says they have fewer extremists.

You sigh, and answer his question.  I'm "the Past", basically.  Clotho, Urðr, Laima; those guys.  It sort of fits; memories are kind of my thing.  But I can't decide anyone's fate; that's something my stupid church made up.  You feel Jace startle at the idea of a Vested not liking their own church, and feel bad for shaking his worldview.  A little.

Wow, OK!  I guess I never thought about.... that.  You feel a small blast of awkwardness from his mind, but he presses on.  So, the Past!  And memories!  Do you need one of my old memories or something?

1) Show him the memory of the sinkhole.

>1
[Show him the memory of the sinkhole.]

You show Jace the snapshot in your mind of the sinkhole.  Oh, man, is that what's about to happen?  I better evacuate the park!

Jace pulls a hand-held microphone off the wall of the ticket booth.

With a squawk, hidden speakers come to life, and you hear Jace say, "Hi, everyone!  Um, the park is now closed.  Everyone needs to leave the park immediately.  The, uh, Army Corps of Engineers reported that, uh, crap, I can't... look.  There's a Vested emergency, okay?  Everyone is in danger; you need to leave right now."

Quinlan Park Entrance (in Jace) (in the ticket booth)
Two booths flank the entrance to the park to the north, where you can buy tickets and get information.  To the south is the parking lot.

In the area, you can sense the collective presence of dozens of spiders.

>n
OK!  Let's figure stuff out! Jace thinks at you.

Plaza (in Jace)
Paths run through this plaza from the south entrance, then splitting northwest around the hill, north up the hill, and east along it. 

In the area, you can sense the collective presence of dozens of spiders.

To the northeast atop the hill is the iconic red metal structure of Coyote's Call.

Prominently displayed just inside the entrance is some sort of sculpture (LS TBD).

>l
Plaza (in Jace)
Paths run through this plaza from the south entrance, then splitting northwest around the hill, north up the hill, and east along it. 

In the area, you can sense the collective presence of dozens of spiders.

To the northeast atop the hill is the iconic red metal structure of Coyote's Call.

Prominently displayed just inside the entrance is some sort of sculpture (LS TBD).

>e
OK!  Let's figure stuff out! Jace thinks at you.

Sculpture By Lot (in Jace)
The path curves from the west to the southeast here, winding through a giant sculpture that looms over the fence by the parking lot.  The main hill of the park is to the north.

In the area, you can sense the collective presence of dozens of spiders.

Up the hill to the north are the red metal tubes and bars of Coyote's Call.

>enter spiders
Gathering your thoughts together, you leave Jace and transfer your consciousness into the spiders.

Sculpture By Lot (in the spiders)
The path curves from the west to the southeast here, winding through a giant sculpture that looms over the fence by the parking lot.  The main hill of the park is to the north.

Up the hill to the north are the red metal tubes and bars of Coyote's Call.

You can also see Jace here.

>n
You transfer your consciousness to a new group of spiders...

Top of Hill (in the spiders)
From the top of the hill, you can see the entire park below you: the reservoir to the north, the playground to the west, and all eight of the permanent sculptures in the park.

A collection of giant metal tubes and beams graces the top of the hill, known as "Coyote's Call".  It's an abstract design of joyful chaos, somehow incorporating even the curve of the hill into its own expression.

>w
You transfer your consciousness to a new group of spiders...

Playground (in the spiders)
You're at the top of the hill in the park.  This side has slides, swings, and a wide variety of brightly-colored climbing equipment.  The path curves from the south to the east side of the hill, along the ridge.

The kids are reluctantly being led or carried away by their parents.

Dominating the sky to the east are the red metal tubes and bars of Coyote's Call.

>search kids
You focus your view to look at the crowd from different perspectives, matching up kids with people looking for them.  Two young boys being picked up from the swings; a little girl stepping off the slide making eye contact with a man putting away a cell phone; a teenage girl carrying one kid and gesturing to a second.  But there--a wide-eyed couple gesturing to each other across the playground, both looking panicked.  Can they not find their kid?

>x kids
You focus your view to look at the crowd from different perspectives, matching up kids with people looking for them.  Two young boys being picked up from the swings; a little girl stepping off the slide making eye contact with a man putting away a cell phone; a teenage girl carrying one kid and gesturing to a second.  But there--a wide-eyed couple gesturing to each other across the playground, both looking panicked.  Can they not find their kid?

>x couple
Two parents are searching the area trying to find their kid.

>touch couple
You lightly touch the couple's mind, sifting through the anxiety and at least get a few phrases:  "hiding again", "Wyatt!", "here just a second ago..."

>enter couple
Both parents are so hyper-focused on finding their kid that there's no space for you to make a more substantive connection.

>x equipment
Aha!  Any kid hiding from normal humans doesn't really stand a chance hiding from a Vested whose consciousness is distributed across hundreds of spiders.  A spider fixing their web under the roundabout can still see a rogue shoe with bits of tattered web on it... attached to a kid curled up in the center.

>x kid
A young boy maybe six years old with tousled hair sporting a few extra leaves and twigs.  He's wearing shorts and a wave-patterned T-shirt, and his hands and knees are completely black with dirt.  He's currently curled up underneath the exact center of the roundabout.

>touch kid
Wyatt is hyper-focused on hiding.

>enter kid
You release your hold of time, and let your mind connect to Wyatt, trying to focus on relatively innocuous memories, to keep him safe as he inevitably tumbles from memory to memory, getting his bearings... 

                                                                *    *    *

 You're telling Jace about the sinkhole, and he pulls the hand-held microphone from the wall, telling everyone there's a Vested emergency... 

                                                                *    *    *

 You're in the back seat of the Hyundai, Amaia driving and Lestar fiddling with the radio, when the voice of an announcer resolves through the static:  "...rts of a plume of smoke from sources up to ten miles away.  Given recent Vested activity in the area, civilians are being asked to leave the area."  Amaia grimly depresses the accelerator, and you fret that you won't get there in time to... 

                                                                *    *    *

 Following your younger brother's lead, you aim your skis more directly downhill, feeling yourself pick up speed... and suddenly Wyatt's presence is gone.  You find yourself in control again, and stop the memory.  Where did he go?

Skiing
You're in your own memory of one of the earlier times you went skiing with your family.  There's light snow in the cold, crisp air.  In the distance is a ski lift.

In your memory, you've just turned your skis straight down the hill to catch up with your brother in the distance.  The reason you remember this moment more vividly is because you're about to crash.

You're pretty sure there should be connections from here to other memories, but you haven't found them yet.

You catch a faint echo of Wyatt's presence here.

>x me
(the memory of yourself)
You're skiing in rented equipment and are all bundled up in hand-me-down winter clothes that don't quite match, but are great at keeping you warm.  You have a determined expression on your face tinged with the exhilaration of going faster than you've gone before.

>x crash
Hesitantly, you play the memory forward slightly and watch yourself as you tip left, overcorrect right, knock the front of your skis together, and tumble over them. 

For a second, as your legs fly over your head, you're a little kid again, learning how to somersault.

You think you could touch the crash to go to a new memory.

>touch crash
You connect with the crash and shift your perception to another memory.

Green Hill
The grassy hill behind your elementary school.  After your best friend Kitty taught you how, you spent every recess for a month somersaulting down this hill.

From here, you can touch somersaulting to connect to other memories.

You don't sense Wyatt's echo here; wherever he's hiding, he must have gone a different way.

>x kitty
Kitty doesn't seem to be present in this version of your memory.

>x hill
Soft grass and a gentle slope; perfect for somersaulting!

>somersault
Whee!

>touch somersaulting
You connect with somersaulting and shift your perception to another memory.

Skiing
You're in your own memory of one of the earlier times you went skiing with your family.  There's light snow in the cold, crisp air.  In the distance is a ski lift.

In your memory, you've just turned your skis straight down the hill to catch up with your brother in the distance.  The reason you remember this moment more vividly is because you're about to crash.

From here, you can touch the crash to connect to other memories, though you sense there may be more connections you haven't found yet.

You catch a faint echo of Wyatt's presence here.

>x snow
Fine, cold, and powdery.

>x air
The cold air was so dry it almost hurt your lungs, but it was invigorating on your cheeks as you flew down the mountain.

>touch snow
You briefly sense other memories of snow throughout your life, but no one memory stands out enough to make a connection.

>touch air
Happily, you have many memories of crisp mountain air, though this means trying to connect to any individual one is impossible.  You briefly connect to the sensation of cold air on your face across all your memories, and feel invigorated.

>x lift
You always enjoyed your time on the ski lift with your brothers.  Cameron even told you he was dating Micah when you were on the lift together once.

You think you could touch the ski lift to go to a new memory.

>touch lift
You connect with the ski lift and shift your perception to another memory.

Cailleach Ski Lift
Another memory; this one during one of your conversations with Cameron as you rode the Cailleach ski lift.

From here, you can touch the ski slopes to connect to other memories, though you sense there may be more connections you haven't found yet.

You catch a faint echo of Wyatt's presence here.

You and Cameron are sitting next to each other on the lift seat, Cameron earnestly telling you about Micah.

>x conversation
When you eventually did meet Micah, it was like you had already met him, just from Cameron's vivid descriptions.

You think you could touch the description of Micah to go to a new memory.

>x micah
When you eventually did meet Micah, it was like you had already met him, just from Cameron's vivid descriptions.

You think you could touch the description of Micah to go to a new memory.

>x cameron
Cameron's face contains, in your memory, all of the emotions from that conversation at the same time.  The shyness of not wanting to tell you; the relief that he finally told someone; the joy in the way he describes Micah to you; the worry he has about eventually telling your folks.

You think you could touch Cameron to go to a new memory.

>x shyness
Cameron's face contains, in your memory, all of the emotions from that conversation at the same time.  The shyness of not wanting to tell you; the relief that he finally told someone; the joy in the way he describes Micah to you; the worry he has about eventually telling your folks.

You think you could touch Cameron to go to a new memory.

>l
Cailleach Ski Lift
Another memory; this one during one of your conversations with Cameron as you rode the Cailleach ski lift.

From here, you can touch Cameron, the description of Micah, and the ski slopes to connect to other memories, though you sense there may be more connections you haven't found yet.

You catch a faint echo of Wyatt's presence here.

>x me
(the memory of yourself)
You feel the intensity with which you listened to Cameron that day, being happy for him not only because he was in love, but also because he found something he cared about that your parents hadn't pushed him into.  Knowing that was possible helped you accept being a Vested, even though you knew your parents would object.

You think you could touch the memory of yourself to go to a new memory.

>l
Cailleach Ski Lift
Another memory; this one during one of your conversations with Cameron as you rode the Cailleach ski lift.

From here, you can touch Cameron, the description of Micah, the memory of yourself, and the ski slopes to connect to other memories.

You catch a faint echo of Wyatt's presence here.

>x memory of myself
You feel the intensity with which you listened to Cameron that day, being happy for him not only because he was in love, but also because he found something he cared about that your parents hadn't pushed him into.  Knowing that was possible helped you accept being a Vested, even though you knew your parents would object.

You think you could touch the memory of yourself to go to a new memory.

>touch description
You connect with the description of Micah and shift your perception to another memory.

Meeting Micah
You finally met Micah five months after Cameron and he started dating.  The details of the theater you're next to are fuzzy, but his smile is perfectly clear.

From here, you can touch Micah to connect to other memories, though you sense there may be more connections you haven't found yet.

You don't sense Wyatt's echo here; wherever he's hiding, he must have gone a different way.

Cameron and Micah were here before you walked up, and Micah is chatting up a storm.

>x theater
Maybe it was one of the historic theaters up in the north end?  You remember that Micah picked the place and the movie, and that you liked the movie.  Whatever it was.

>x cameron
Cameron is laughing at something Micah said, and looks more relaxed than you've ever seen him.

You think you could touch Cameron to go to a new memory.

>x micah
Micah was already grinning as you walked up, but his face positively lit up when he noticed you.  You'd classify Micah's outfit that evening as "studied casual":  nothing too fancy; nothing to flamboyant, but everything immaculately clean and wrinkle-free.

>x me
Your consciousness has no literal form, but when you move across minds, you imagine your core self as a tight ball of sparks containing your memories.

>x micah
Micah was already grinning as you walked up, but his face positively lit up when he noticed you.  You'd classify Micah's outfit that evening as "studied casual":  nothing too fancy; nothing to flamboyant, but everything immaculately clean and wrinkle-free.

>x cameron
Cameron is laughing at something Micah said, and looks more relaxed than you've ever seen him.

You think you could touch Cameron to go to a new memory.

>x cameron
Cameron is laughing at something Micah said, and looks more relaxed than you've ever seen him.

You think you could touch Cameron to go to a new memory.

>l
Meeting Micah
You finally met Micah five months after Cameron and he started dating.  The details of the theater you're next to are fuzzy, but his smile is perfectly clear.

From here, you can touch Micah and Cameron to connect to other memories.

You don't sense Wyatt's echo here; wherever he's hiding, he must have gone a different way.

>x smile
Micah was already grinning as you walked up, but his face positively lit up when he noticed you.  You'd classify Micah's outfit that evening as "studied casual":  nothing too fancy; nothing to flamboyant, but everything immaculately clean and wrinkle-free.

>touch micah
You connect with Micah and shift your perception to another memory.

Cailleach Ski Lift
Another memory; this one during one of your conversations with Cameron as you rode the Cailleach ski lift.

From here, you can touch Cameron, the description of Micah, the memory of yourself, and the ski slopes to connect to other memories.

You catch a faint echo of Wyatt's presence here.

>touch cameron
You connect with Cameron and shift your perception to another memory.

Arguing about Micah
In this memory, you're in your family's kitchen, in the aftermath of Cameron telling your parents about Micah.  The dripping faucet punctuates this new target of their insistence on perfection, and adds an inconsistent drumbeat to the familiar refrain of how you all failed, and needed to be better about everything.

From here, you can touch Cameron to connect to other memories, though you sense there may be more connections you haven't found yet.

You don't sense Wyatt's echo here; wherever he's hiding, he must have gone a different way.

The argument hangs around the kitchen like a cloud.

>x argument
You and Cameron knew telling your parents about Micah would start an argument, because everything important always started arguments.  But truth be told, you both thought they'd try to argue Cameron out of being gay, but they didn't care about that in the slightest.  Instead, they tried to argue Cameron out of dating Micah.  Didn't he live down by that old bowling alley?  And he's studying music; isn't that kind of a waste?  You should have told us you were gay earilier; we could have introduced you to Mrs. Farthington's son; he's gay and just went off to Harvard.  But he'll still be there if you get in; you know you only have a few more months left to apply...

Cameron was clearly angry, but bless him, he didn't back down.  You didn't help much, but at least you were there.

Wait.  Lestar keeps telling you that you give yourself too little credit.  Maybe... maybe you actually did more?

>x argument
You and Cameron knew telling your parents about Micah would start an argument, because everything important always started arguments.  But truth be told, you both thought they'd try to argue Cameron out of being gay, but they didn't care about that in the slightest.  Instead, they tried to argue Cameron out of dating Micah.  Didn't he live down by that old bowling alley?  And he's studying music; isn't that kind of a waste?  You should have told us you were gay earilier; we could have introduced you to Mrs. Farthington's son; he's gay and just went off to Harvard.  But he'll still be there if you get in; you know you only have a few more months left to apply...

Cameron was clearly angry, but bless him, he didn't back down.  You didn't say a lot, but you stepped in with something every time Cameron's arguments flagged.  And now that you're looking at this a bit more clearly, you remember the grateful looks he gave you when you did.

You think you could touch the argument to go to a new memory.

>x wyatt
Wyatt doesn't seem to have visited this memory at all.

>x me
Your consciousness has no literal form, but when you move across minds, you imagine your core self as a tight ball of sparks containing your memories.

>x faucet
Your dad turned away from the dishes to argue with Cameron, and didn't manage to turn the faucet off entirely when he did.  The irregular drips drove you crazy, and you couldn't get around your father to turn it off again.  You briefly considered finding the house's shutoff valve just to get it to quit, but of course, you couldn't leave Cameron here undefended.

>x kitchen
You can't see any such thing.

>touch argument
You connect with the argument and shift your perception to another memory.

Your Own Kitchen Argument
Eight months ago.  You were just back from your first Vested crisis at the Northfield ffice complex.  You were furiously scrubbing dishes, trying to vicariously wipe away the pain and anger and darkness that clung to you from the shooter's mind. Your mom came in to talk to you about it after listening to the news report, ostenstibly to be sympathetic but somehow explaining that everything you did was wrong, and how you could have done everything better.

The argument hangs around the kitchen like a cloud.

>x wyatt
You can tell Wyatt has been through here, though you can't tell which memory connection he used when he left.

>x dishes
You were tired, angry, elated, and worried all at once, but all your mom seemed to see was a bundle of mistakes.  You had just been through so much.

You think you could touch the memory of yourself to go to a new memory.

>x argument
You desperately wanted to share with your mom how scared you had been; how dreadful the shooter's mind was; how satisfying it was to reweave fate to save so many people; how the images of so many dead and dying still haunt you, even though you unwove their deaths from existence.  But every time you admitted any weakness; any mistake; any regret, your mother pounced on it like a hawk, tearing to pieces any connection or comfort with her endless litany of what to do next time, how to improve, why would you even.

You can touch the argument to go to Arguing about Micah.

>touch me
(the memory of yourself)
You connect with the memory of yourself and shift your perception to another memory.

Outside the Office Complex
Eight months ago, morning.  Everything frozen in time, your perspective distributed across hundreds of spiders.  Amaia's prophecy had warned the three of you with barely enough time to get there as the first shot was fired; without your ability to extend the Moirai Bubble into the past, the earliest victims would have surely died.

A bullet hangs in the air, frozen in its trajectory.

Four passersby had the misfortune of happening to be walking by this office at this moment.

>x bullet
Small enough that you didn't see it your first time though, the bullet hangs in the air, aimed directly at the young man on the sidewalk.

>x young man
Paul was trying to make it from his dorm room at the university to his intership at the office.  Never heard the shot that killed him (originally) and simply wouldn't believe he was in danger when you visited him before this moment.

>x me
(the memory of yourself)
Despite practicing for weeks, you were still disoriented from the ritual, and unsure how on earth "entering people's minds and talking to them" was going to help.  But you were bolstered by Lestar's confidence and Amaia's competence, determined to do your best.

>l
Outside the Office Complex
Eight months ago, morning.  Everything frozen in time, your perspective distributed across hundreds of spiders.  Amaia's prophecy had warned the three of you with barely enough time to get there as the first shot was fired; without your ability to extend the Moirai Bubble into the past, the earliest victims would have surely died.

A bullet hangs in the air, frozen in its trajectory.

Four passersby had the misfortune of happening to be walking by this office at this moment.

>x prophecy
You can't see any such thing.

>x passersby
The first was a young man named Paul, the second, a middle aged woman named Bethany, and the third, an older gentleman named Nat.  Paul was the first to get shot, but you watched them all die too many times before finally weaving them safe.

>x bethany
Bethany was here for an interview, and immaculately dressed in a GET DESCRIPTION FROM SARA.

>x older
Nat's a retired army vet, who was in the area just because it was a place he hadn't walked yet.

>l
Outside the Office Complex
Eight months ago, morning.  Everything frozen in time, your perspective distributed across hundreds of spiders.  Amaia's prophecy had warned the three of you with barely enough time to get there as the first shot was fired; without your ability to extend the Moirai Bubble into the past, the earliest victims would have surely died.

A bullet hangs in the air, frozen in its trajectory.

Four passersby had the misfortune of happening to be walking by this office at this moment.

>x fourth
Wait... there *were* four people walking by that morning, but you only ever interacted with three of them.  Who was the fourth person, and why didn't you notice them at the time?

You hear a young boy's giggle echo across your memory.

>x fourth
You struggle, trying to clarify the fourth person in your memory.  It's a woman, you can't rememer how old, wearing a scarf and looking intently at... a spider.  At you.

>x woman
(the mysterious woman)
The fourth person is a woman of indeterminate age, wearing a scarf, and looking intently at one of the spiders you were inhabiting.

>x scarf
Focusing intently on your memory, you think you can make out a design on the scarf: two crossed lines circumscribed by a rounded triangle.

Wait.  That's the same design that you saw on the spear of metal from Coyote's Call.

>x scarf
Focusing intently on your memory, you think you can make out a design on the scarf: two crossed lines circumscribed by a rounded triangle.  It's definitely the same design that you saw on the unearthed base of the bit of Coyote's Call you caught as it plunged into the sinkhole.

>x wyatt
Wyatt is here, somewhere.  Now you just have to figure out what (or who) he's hiding inside.

>touch woman
(the mysterious woman)
Hesitantly, you reach out to connect with the mysterious woman... and just as you do, Wyatt leaps out, laughing.  "You found me!" he exclaims, laughing even more because he knows he startled you.  "I saw her in the hiding zone so I hid in there with her!"

"What's the "hiding zone"?" you ask.

 "It's the place you only see when you're hiding!  That's the secret to hide and seek.  When you're looking, you have to pretend you're hiding.  Then you see the hiding zone!"

You shake your head, because that made entirely too much sense.  You look over at the frozen image of the woman in your memory, and wonder what it was that created "the hiding zone" around her.  Some other Vested power?

You sigh.  "Wyatt, I found you; that means you have to stop hiding and go with your parents; they're worried about you.

"Aww, OK," says Wyatt.  "See you around, spider lady!"  And...he's gone from your head entirely.

Playground (in the spiders)
You're at the top of the hill in the park.  This side has slides, swings, and a wide variety of brightly-colored climbing equipment.  The path curves from the south to the east side of the hill, along the ridge.

Wyatt's emerged from his hiding spot and has reunited with his parents.

Wyatt's parents seem exasperated but relieved that they finally found him.

The kids are reluctantly being led or carried away by their parents.

Dominating the sky to the east are the red metal tubes and bars of Coyote's Call.

>z
Gently, you release your hold on time, letting it scroll forward.

The relieved couple go south.

Wyatt goes south.

A cloud passes over the sun.

>s
You transfer your consciousness to a new group of spiders...

Plaza (in the spiders)
Paths run through this plaza from the south entrance, then splitting northwest around the hill, north up the hill, and east along it. 

Wyatt's emerged from his hiding spot and has reunited with his parents.

Wyatt's parents seem exasperated but relieved that they finally found him.

To the northeast atop the hill is the iconic red metal structure of Coyote's Call.

Prominently displayed just inside the entrance is some sort of sculpture (LS TBD).

>z
Gently, you release your hold on time, letting it scroll forward.

The relieved couple go south.

Wyatt goes south.

>s
You transfer your consciousness to a new group of spiders...

Quinlan Park Entrance (in the spiders)
Two booths flank the entrance to the park to the north, where you can buy tickets and get information.  To the south is the parking lot.

Wyatt's emerged from his hiding spot and has reunited with his parents.

Wyatt's parents seem exasperated but relieved that they finally found him.

>z
Gently, you release your hold on time, letting it scroll forward.

The relieved couple go south.

Wyatt goes south.

You feel a slight tremor in the earth from somewhere nearby.

>s
You transfer your consciousness to a new group of spiders...

Quinlan Park Parking Lot (in the spiders)
Scattered cars fill the parking lot, but your Hyundai hasn't arrived yet. The parking lot is just off of 48th street to the west.   To the north is the entrance to the park.

Wyatt's emerged from his hiding spot and has reunited with his parents.

Wyatt's parents seem exasperated but relieved that they finally found him.

Looming over the parking lot to the east is a huge sculpture  whose details have yet to be decided (LS TBD).

>z
Gently, you release your hold on time, letting it scroll forward.

You hear a roar from inside the park.

>reset
You feel the web of time time tighten beneath you, and with a rush, you slip backwards along it.  Images blur past you before the web finally goes slack again, and you regain your hold.

Quinlan Park Parking Lot (in the spiders)
Scattered cars fill the parking lot, but your Hyundai hasn't arrived yet. The parking lot is just off of 48th street to the west.   To the north is the entrance to the park.

Looming over the parking lot to the east is a huge sculpture  whose details have yet to be decided (LS TBD).

>n
You transfer your consciousness to a new group of spiders...

Quinlan Park Entrance (in the spiders)
Two booths flank the entrance to the park to the north, where you can buy tickets and get information.  To the south is the parking lot.

You can see Jace manning the ticket booth, but the information booth is empty.

>n
You transfer your consciousness to a new group of spiders...

Plaza (in the spiders)
Paths run through this plaza from the south entrance, then splitting northwest around the hill, north up the hill, and east along it. 

To the northeast atop the hill is the iconic red metal structure of Coyote's Call.

Prominently displayed just inside the entrance is some sort of sculpture (LS TBD).

>n
You transfer your consciousness to a new group of spiders...

Playground (in the spiders)
You're at the top of the hill in the park.  This side has slides, swings, and a wide variety of brightly-colored climbing equipment.  The path curves from the south to the east side of the hill, along the ridge.

Kids are playing, shrieking, and chasing each other up and around the platforms.

Dominating the sky to the east are the red metal tubes and bars of Coyote's Call.

>z
Gently, you release your hold on time, letting it scroll forward.

With a squawk, hidden speakers come to life, and you hear Jace say, "Hi, everyone!  Um, the park is now closed.  Everyone needs to leave the park immediately.  The, uh, Army Corps of Engineers reported that, uh, crap, I can't... look.  There's a Vested emergency, okay?  Everyone is in danger; you need to leave right now."

The couple looks through all the kids, trying to find their own.

>z
Gently, you release your hold on time, letting it scroll forward.

The couple looks around, behind, and under all the playground equipment, searching for their kid.

>z
Gently, you release your hold on time, letting it scroll forward.

Wyatt emerges from under the roundabout, and his parents immediately exclaim and run over to him, relieved.

>z
Gently, you release your hold on time, letting it scroll forward.

The worried couple go south.

Wyatt goes south.

A cloud passes over the sun.

>reset
You feel the web of time time tighten beneath you, and with a rush, you slip backwards along it.  Images blur past you before the web finally goes slack again, and you regain your hold.

Playground (in the spiders)
You're at the top of the hill in the park.  This side has slides, swings, and a wide variety of brightly-colored climbing equipment.  The path curves from the south to the east side of the hill, along the ridge.

Kids are playing, shrieking, and chasing each other up and around the platforms.

Dominating the sky to the east are the red metal tubes and bars of Coyote's Call.

>z
Gently, you release your hold on time, letting it scroll forward.

With a squawk, hidden speakers come to life, and you hear Jace say, "Hi, everyone!  Um, the park is now closed.  Everyone needs to leave the park immediately.  The, uh, Army Corps of Engineers reported that, uh, crap, I can't... look.  There's a Vested emergency, okay?  Everyone is in danger; you need to leave right now."

The couple looks through all the kids, trying to find their own.

>l
Playground (in the spiders)
You're at the top of the hill in the park.  This side has slides, swings, and a wide variety of brightly-colored climbing equipment.  The path curves from the south to the east side of the hill, along the ridge.

A couple is searching for their kid, and can't seem to find them.

Wyatt is here, hiding under the roundabout.

The kids are reluctantly being led or carried away by their parents.

Dominating the sky to the east are the red metal tubes and bars of Coyote's Call.

>enter wyatt
You've already chased Wyatt through your mind once.  Would you like to do all that again or just do what you did last time and skip to the end?

1) Chase Wyatt through your own mind again.
2) Skip to finding Wyatt hiding in your memory of a mysterious woman.

>2
[Skip to finding Wyatt hiding in your memory of a mysterious woman.]

Hesitantly, you reach out to connect with the mysterious woman... and just as you do, Wyatt leaps out, laughing.  "You found me!" he exclaims, laughing even more because he knows he startled you.  "I saw her in the hiding zone so I hid in there with her!"

"What's the "hiding zone"?" you ask.

 "It's the place you only see when you're hiding!  That's the secret to hide and seek.  When you're looking, you have to pretend you're hiding.  Then you see the hiding zone!"

You shake your head, because that made entirely too much sense.  You look over at the frozen image of the woman in your memory, and wonder what it was that created "the hiding zone" around her.  Some other Vested power?

You sigh.  "Wyatt, I found you; that means you have to stop hiding and go with your parents; they're worried about you.

"Aww, OK," says Wyatt.  "See you around, spider lady!"  And...he's gone from your head entirely.

Playground (in the spiders)
You're at the top of the hill in the park.  This side has slides, swings, and a wide variety of brightly-colored climbing equipment.  The path curves from the south to the east side of the hill, along the ridge.

Wyatt's parents seem exasperated but relieved that they finally found him.

Wyatt's emerged from his hiding spot and has reunited with his parents.

The kids are reluctantly being led or carried away by their parents.

Dominating the sky to the east are the red metal tubes and bars of Coyote's Call.

>z
Gently, you release your hold on time, letting it scroll forward.

The relieved couple go south.

Wyatt goes south.

>s
You transfer your consciousness to a new group of spiders...

Plaza (in the spiders)
Paths run through this plaza from the south entrance, then splitting northwest around the hill, north up the hill, and east along it. 

Wyatt's emerged from his hiding spot and has reunited with his parents.

Wyatt's parents seem exasperated but relieved that they finally found him.

To the northeast atop the hill is the iconic red metal structure of Coyote's Call.

Prominently displayed just inside the entrance is some sort of sculpture (LS TBD).

>n
You transfer your consciousness to a new group of spiders...

Playground (in the spiders)
You're at the top of the hill in the park.  This side has slides, swings, and a wide variety of brightly-colored climbing equipment.  The path curves from the south to the east side of the hill, along the ridge.

The kids are reluctantly being led or carried away by their parents.

Dominating the sky to the east are the red metal tubes and bars of Coyote's Call.

>reset
You feel the web of time time tighten beneath you, and with a rush, you slip backwards along it.  Images blur past you before the web finally goes slack again, and you regain your hold.

Playground (in the spiders)
You're at the top of the hill in the park.  This side has slides, swings, and a wide variety of brightly-colored climbing equipment.  The path curves from the south to the east side of the hill, along the ridge.

Kids are playing, shrieking, and chasing each other up and around the platforms.

Dominating the sky to the east are the red metal tubes and bars of Coyote's Call.

>enter wyatt
You can't interact with a memory like that.

>z
Gently, you release your hold on time, letting it scroll forward.

With a squawk, hidden speakers come to life, and you hear Jace say, "Hi, everyone!  Um, the park is now closed.  Everyone needs to leave the park immediately.  The, uh, Army Corps of Engineers reported that, uh, crap, I can't... look.  There's a Vested emergency, okay?  Everyone is in danger; you need to leave right now."

Wyatt emerges from under the roundabout, and his parents immediately exclaim and run over to him, relieved.

>enter wyatt
You've already chased Wyatt through your mind once.  Would you like to do all that again or just do what you did last time and skip to the end?

1) Chase Wyatt through your own mind again.
2) Skip to finding Wyatt hiding in your memory of a mysterious woman.

>1
[Chase Wyatt through your own mind again.]

Playground (in the spiders)
You're at the top of the hill in the park.  This side has slides, swings, and a wide variety of brightly-colored climbing equipment.  The path curves from the south to the east side of the hill, along the ridge.

A couple is searching for their kid, and can't seem to find them.

Wyatt is here, hiding under the roundabout.

The kids are reluctantly being led or carried away by their parents.

Dominating the sky to the east are the red metal tubes and bars of Coyote's Call.

You release your hold of time, and let your mind connect to Wyatt, trying to focus on relatively innocuous memories, to keep him safe as he inevitably tumbles from memory to memory, getting his bearings... 

                                                                *    *    *

 You're telling Jace about the sinkhole, and he pulls the hand-held microphone from the wall, telling everyone there's a Vested emergency... 

                                                                *    *    *

 You're in the back seat of the Hyundai, Amaia driving and Lestar fiddling with the radio, when the voice of an announcer resolves through the static:  "...rts of a plume of smoke from sources up to ten miles away.  Given recent Vested activity in the area, civilians are being asked to leave the area."  Amaia grimly depresses the accelerator, and you fret that you won't get there in time to... 

                                                                *    *    *

 Following your younger brother's lead, you aim your skis more directly downhill, feeling yourself pick up speed... and suddenly Wyatt's presence is gone.  You find yourself in control again, and stop the memory.  Where did he go?

Skiing
You're in your own memory of one of the earlier times you went skiing with your family.  There's light snow in the cold, crisp air.  In the distance is a ski lift.

In your memory, you've just turned your skis straight down the hill to catch up with your brother in the distance.  The reason you remember this moment more vividly is because you're about to crash.

From here, you can touch the crash and the ski lift to connect to other memories.

You catch a faint echo of Wyatt's presence here.

>touch lift
You connect with the ski lift and shift your perception to another memory.

Cailleach Ski Lift
Another memory; this one during one of your conversations with Cameron as you rode the Cailleach ski lift.

From here, you can touch Cameron, the description of Micah, the memory of yourself, and the ski slopes to connect to other memories.

You catch a faint echo of Wyatt's presence here.

>touch me
(the memory of yourself)
You connect with the memory of yourself and shift your perception to another memory.

Your Own Kitchen Argument
Eight months ago.  You were just back from your first Vested crisis at the Northfield ffice complex.  You were furiously scrubbing dishes, trying to vicariously wipe away the pain and anger and darkness that clung to you from the shooter's mind. Your mom came in to talk to you about it after listening to the news report, ostenstibly to be sympathetic but somehow explaining that everything you did was wrong, and how you could have done everything better.

The argument hangs around the kitchen like a cloud.

>touch argument
You connect with the argument and shift your perception to another memory.

Arguing about Micah
In this memory, you're in your family's kitchen, in the aftermath of Cameron telling your parents about Micah.  The dripping faucet punctuates this new target of their insistence on perfection, and adds an inconsistent drumbeat to the familiar refrain of how you all failed, and needed to be better about everything.

From here, you can touch Cameron and the argument to connect to other memories.

You don't sense Wyatt's echo here; wherever he's hiding, he must have gone a different way.

>undo
Your Own Kitchen Argument
You step backwards on the strands.

>touch me
(the memory of yourself)
You connect with the memory of yourself and shift your perception to another memory.

Outside the Office Complex
Eight months ago, morning.  Everything frozen in time, your perspective distributed across hundreds of spiders.  Amaia's prophecy had warned the three of you with barely enough time to get there as the first shot was fired; without your ability to extend the Moirai Bubble into the past, the earliest victims would have surely died.

A bullet hangs in the air, frozen in its trajectory.

Four passersby had the misfortune of happening to be walking by this office at this moment.

Somehow, you never directly noticed the fourth passerby before, but now that you know she was there, you can mostly see her in your memory.

>x fourth
The fourth person is a woman of indeterminate age, wearing a scarf, and looking intently at one of the spiders you were inhabiting.

>x scarf
Focusing intently on your memory, you think you can make out a design on the scarf: two crossed lines circumscribed by a rounded triangle.  It's definitely the same design that you saw on the unearthed base of the bit of Coyote's Call you caught as it plunged into the sinkhole.

>touch fourth
Hesitantly, you reach out to connect with the mysterious woman... and just as you do, Wyatt leaps out, laughing.  "You found me!" he exclaims, laughing even more because he knows he startled you.  "I saw her in the hiding zone so I hid in there with her!"

"What's the "hiding zone"?" you ask.

 "It's the place you only see when you're hiding!  That's the secret to hide and seek.  When you're looking, you have to pretend you're hiding.  Then you see the hiding zone!"

You shake your head, because that made entirely too much sense.  You look over at the frozen image of the woman in your memory, and wonder what it was that created "the hiding zone" around her.  Some other Vested power?

You sigh.  "Wyatt, I found you; that means you have to stop hiding and go with your parents; they're worried about you.

"Aww, OK," says Wyatt.  "See you around, spider lady!"  And...he's gone from your head entirely.

Playground (in the spiders)
You're at the top of the hill in the park.  This side has slides, swings, and a wide variety of brightly-colored climbing equipment.  The path curves from the south to the east side of the hill, along the ridge.

Wyatt's parents seem exasperated but relieved that they finally found him.

Wyatt's emerged from his hiding spot and has reunited with his parents.

The kids are reluctantly being led or carried away by their parents.

Dominating the sky to the east are the red metal tubes and bars of Coyote's Call.

* * *

>x couple
Two parents are searching the area trying to find their kid.

>x kid
Aha!  Any kid hiding from normal humans doesn't really stand a chance hiding from a Vested whose consciousness is distributed across hundreds of spiders.  A spider fixing their web under the roundabout can still see a rogue shoe with bits of tattered web on it.

>x kid
A young boy maybe six years old with tousled hair sporting a few extra leaves and twigs.  He's wearing shorts and a wave-patterned T-shirt, and his hands and knees are completely black with dirt.

>touch kid
The young boy is hyper-focused on hiding.

>enter kid
You release your hold of time, and let your mind connect to the boy (whose name seems to be Wyatt), trying to focus on relatively innocuous memories, to keep him safe as he inevitably tumbles from memory to memory, getting his bearings... 

                                                                  *    *    *

 You're telling Jace about the sinkhole, and he pulls the hand-held microphone from the wall, telling everyone there's a Vested emergency... 

                                                                  *    *    *

 You're in the back seat of the Hyundai, Amaia driving and Lestar fiddling with the radio, when the voice of an announcer resolves through the static:  "...rts of a plume of smoke from sources up to ten miles away.  Given recent Vested activity in the area, civilians are being asked to leave the area."  Amaia grimly depresses the accelerator, and you fret that you won't get there in time to... 

                                                                  *    *    *

 Following your younger brother's lead, you aim your skis more directly downhill, feeling yourself pick up speed... and suddenly Wyatt's presence is gone.  You find yourself in control again, and stop the memory.  Where did he go?

Skiing
You're in your own memory of one of the earlier times you went skiing with your family.  There's light snow in the cold, crisp air.  In the distance is a ski lift.

In your memory, you've just turned your skis straight down the hill to catch up with your brother in the distance.  The reason the memory of yourself remember this moment more vividly is because you're about to crash.

You're pretty sure there should be connections from here to other memories, but you haven't found them yet.

You catch a faint echo of Wyatt's presence here.

* * *

>x couple
Two parents are searching the area trying to find their kid.

>z
Gently, you release your hold on time, letting it scroll forward.

The couple looks around, behind, and under all the playground equipment, searching for their kid.

A cloud passes over the sun.

>z
Gently, you release your hold on time, letting it scroll forward.

The couple looks through all the kids, trying to find their own.

>z
Gently, you release your hold on time, letting it scroll forward.

The couple looks around, behind, and under all the playground equipment, searching for their kid.

You feel a slight tremor in the earth from somewhere nearby.

>l
Playground (in the spiders)
You're at the top of the hill in the park.  This side has slides, swings, and a wide variety of brightly-colored climbing equipment.  The path curves from the south to the east side of the hill, along the ridge.

The young boy's got to be around here somewhere...

A couple is searching for their kid, and can't seem to find them.

The kids are reluctantly being led or carried away by their parents.

Dominating the sky to the east are the red metal tubes and bars of Coyote's Call.

>x wyatt
Aha!  Any kid hiding from normal humans doesn't really stand a chance hiding from a Vested whose consciousness is distributed across hundreds of spiders.  A spider fixing their web under the roundabout can still see a rogue shoe with bits of tattered web on it... attached to a kid curled up in the center.

* * *

>z
Gently, you release your hold on time, letting it scroll forward.

The couple looks around, behind, and under all the playground equipment, searching for their kid.

You feel a slight tremor in the earth from somewhere nearby.

>search kids
You focus your view to look at the crowd from different perspectives, matching up kids with people looking for them.  Two young boys being picked up from the swings; a little girl stepping off the slide making eye contact with a man putting away a cell phone; a teenage girl carrying one kid and gesturing to a second.  But there--a wide-eyed couple gesturing to each other across the playground, both looking panicked.  Can they not find their kid?

>rules
Rules tracing now switched on. Type "rules off" to switch it off again, or "rules all" to include even rules which do not apply.

[Rule "parse command rule" applies.]

* * *

>z
[Rule "Response Assistant reset responses list rule" applies.]
[Rule "declare everything initially unmentioned rule" applies.]
[Rule "generate action rule" applies.]
[Rule "announce items from multiple object lists rule" applies.]
[Rule "set pronouns from items from multiple object lists rule" applies.]
[Rule "before stage rule" applies.]
[Rule "basic visibility rule" applies.]
[Rule "basic accessibility rule" applies.]
[Rule "carrying requirements rule" applies.]
[Rule "instead stage rule" applies.]
[Rule "requested actions require persuasion rule" applies.]
[Rule "carry out requested actions rule" applies.]
[Rule "descend to specific action-processing rule" applies.]
[Rule "work out details of specific action rule" applies.]
[Rule "investigate player's awareness before action rule" applies.]
[Rule "player aware of his own actions rule" applies.]
[Rule "check stage rule" applies.]
[Rule "carry out stage rule" applies.]
[Rule "after stage rule" applies.]
[Rule "investigate player's awareness after action rule" applies.]
[Rule "report stage rule" applies.]
[Rule "standard report waiting rule" applies.]
Gently, you release your hold on time, letting it scroll forward.
[Rule "last specific action-processing rule" applies.]

[Rule "A first turn sequence rule" applies.]
[Rule "scene change machinery rule" applies.]
[Rule "take quick actions out of world rule" applies.]
[Rule "every turn stage rule" applies.]
[Rule "Every turn" applies.]
[Rule "announce items from multiple object lists rule" applies.]
[Rule "set pronouns from items from multiple object lists rule" applies.]
[Rule "before stage rule" applies.]
[Rule "basic visibility rule" applies.]
[Rule "basic accessibility rule" applies.]
[Rule "carrying requirements rule" applies.]
[Rule "instead stage rule" applies.]
[Rule "requested actions require persuasion rule" applies.]
[Rule "carry out requested actions rule" applies.]
[Rule "descend to specific action-processing rule" applies.]
[Rule "work out details of specific action rule" applies.]
[Rule "investigate player's awareness before action rule" applies.]
[Rule "player aware of his own actions rule" applies.]
[Rule "player aware of actions by visible actors rule" applies.]
[Rule "check stage rule" applies.]
[Rule "carry out stage rule" applies.]
[Rule "after stage rule" applies.]
[Rule "investigate player's awareness after action rule" applies.]
[Rule "report stage rule" applies.]
[Rule "report other people examining rule" applies.]
The worried couple look closely at the climbing equipment.
[Rule "last specific action-processing rule" applies.]

[Rule "timed events rule" applies.]
[Rule "advance time rule" applies.]
[Rule "update chronological records rule" applies.]
[Rule "A last turn sequence rule" applies.]
[Rule "scene change machinery rule" applies.]
[Rule "adjust light rule" applies.]
[Rule "note object acquisitions rule" applies.]
[Rule "notify score changes rule" applies.]
[Rule "parse command rule" applies.]